ascension-island: Flag for Ascension Island
andorra: Flag for Andorra
united-arab-emirates: Flag for United Arab Emirates
afghanistan: Flag for Afghanistan
antigua-barbuda: Flag for Antigua & Barbuda
anguilla: Flag for Anguilla
albania: Flag for Albania
armenia: Flag for Armenia
angola: Flag for Angola
antarctica: Flag for Antarctica
argentina: Flag for Argentina
american-samoa: Flag for American Samoa
austria: Flag for Austria
australia: Flag for Australia
aruba: Flag for Aruba
aland-islands: Flag for Aland Islands
azerbaijan: Flag for Azerbaijan
bosnia-herzegovina: Flag for Bosnia & Herzegovina
barbados: Flag for Barbados
bangladesh: Flag for Bangladesh
belgium: Flag for Belgium
burkina-faso: Flag for Burkina Faso
bulgaria: Flag for Bulgaria
bahrain: Flag for Bahrain
burundi: Flag for Burundi
benin: Flag for Benin
st-barthelemy: Flag for St. Barthelemy
bermuda: Flag for Bermuda
brunei: Flag for Brunei
bolivia: Flag for Bolivia
caribbean-netherlands: Flag for Caribbean Netherlands
brazil: Flag for Brazil
bahamas: Flag for Bahamas
bhutan: Flag for Bhutan
bouvet-island: Flag for Bouvet Island
botswana: Flag for Botswana
belarus: Flag for Belarus
belize: Flag for Belize
canada: Flag for Canada
cocos-islands: Flag for Cocos Islands
congo-kinshasa: Flag for Congo - Kinshasa
central-african-republic: Flag for Central African Republic
congo-brazzaville: Flag for Congo - Brazzaville
switzerland: Flag for Switzerland
cote-d'ivoire: Flag for Cote d'Ivoire
chile: Flag for Chile
cameroon: Flag for Cameroon
china: Flag for China
colombia: Flag for Colombia
clipperton-island: Flag for Clipperton Island
costa-rica: Flag for Costa Rica
cuba: Flag for Cuba
cape-verde: Flag for Cape Verde
curacao: Flag for Curacao
christmas-island: Flag for Christmas Island
cyprus: Flag for Cyprus
czech-republic: Flag for Czech Republic
germany: Flag for Germany
diego-garcia: Flag for Diego Garcia
djibouti: Flag for Djibouti
dominica: Flag for Dominica
dominican-republic: Flag for Dominican Republic
algeria: Flag for Algeria
ceuta-melilla: Flag for Ceuta & Melilla
ecuador: Flag for Ecuador
estonia: Flag for Estonia
egypt: Flag for Egypt
western-sahara: Flag for Western Sahara
eritrea: Flag for Eritrea
spain: Flag for Spain
ethiopia: Flag for Ethiopia
european-union: Flag for European Union
finland: Flag for Finland
fiji: Flag for Fiji
micronesia: Flag for Micronesia
faroe-islands: Flag for Faroe Islands
france: Flag for France
gabon: Flag for Gabon
united-kingdom: Flag for United Kingdom
grenada: Flag for Grenada
georgia: Flag for Georgia
french-guiana: Flag for French Guiana
guernsey: Flag for Guernsey
ghana: Flag for Ghana
gibraltar: Flag for Gibraltar
greenland: Flag for Greenland
gambia: Flag for Gambia
guinea: Flag for Guinea
guadeloupe: Flag for Guadeloupe
equatorial-guinea: Flag for Equatorial Guinea
greece: Flag for Greece
south-georgia-south-sandwich-islands: Flag for South Georgia & South Sandwich Islands
guatemala: Flag for Guatemala
guam: Flag for Guam
guinea-bissau: Flag for Guinea-Bissau
guyana: Flag for Guyana
heard-mcdonald-islands: Flag for Heard & McDonald Islands
honduras: Flag for Honduras
croatia: Flag for Croatia
haiti: Flag for Haiti
hungary: Flag for Hungary
canary-islands: Flag for Canary Islands
indonesia: Flag for Indonesia
ireland: Flag for Ireland
israel: Flag for Israel
isle-of-man: Flag for Isle of Man
india: Flag for India
british-indian-ocean-territory: Flag for British Indian Ocean Territory
iraq: Flag for Iraq
iran: Flag for Iran
iceland: Flag for Iceland
italy: Flag for Italy
jersey: Flag for Jersey
jamaica: Flag for Jamaica
jordan: Flag for Jordan
japan: Flag for Japan
laos: Flag for Laos
lebanon: Flag for Lebanon
st-lucia: Flag for St. Lucia
liechtenstein: Flag for Liechtenstein
liberia: Flag for Liberia
lesotho: Flag for Lesotho
lithuania: Flag for Lithuania
luxembourg: Flag for Luxembourg
latvia: Flag for Latvia
libya: Flag for Libya
morocco: Flag for Morocco
monaco: Flag for Monaco
moldova: Flag for Moldova
montenegro: Flag for Montenegro
st-martin: Flag for St. Martin
madagascar: Flag for Madagascar
marshall-islands: Flag for Marshall Islands
mali: Flag for Mali
myanmar: Flag for Myanmar
mongolia: Flag for Mongolia
macau: Flag for Macau
northern-mariana-islands: Flag for Northern Mariana Islands
martinique: Flag for Martinique
mauritania: Flag for Mauritania
montserrat: Flag for Montserrat
malta: Flag for Malta
mauritius: Flag for Mauritius
maldives: Flag for Maldives
malawi: Flag for Malawi
mexico: Flag for Mexico
malaysia: Flag for Malaysia
mozambique: Flag for Mozambique
namibia: Flag for Namibia
new-caledonia: Flag for New Caledonia
niger: Flag for Niger
norfolk-island: Flag for Norfolk Island
nigeria: Flag for Nigeria
nicaragua: Flag for Nicaragua
netherlands: Flag for Netherlands
norway: Flag for Norway
nepal: Flag for Nepal
nauru: Flag for Nauru
niue: Flag for Niue
new-zealand: Flag for New Zealand
oman: Flag for Oman
panama: Flag for Panama
peru: Flag for Peru
french-polynesia: Flag for French Polynesia
papua-new-guinea: Flag for Papua New Guinea
philippines: Flag for Philippines
poland: Flag for Poland
st-pierre-miquelon: Flag for St. Pierre & Miquelon
pitcairn-islands: Flag for Pitcairn Islands
puerto-rico: Flag for Puerto Rico
palestinian-territories: Flag for Palestinian Territories
portugal: Flag for Portugal
palau: Flag for Palau
paraguay: Flag for Paraguay
qatar: Flag for Qatar
reunion: Flag for Reunion
romania: Flag for Romania
serbia: Flag for Serbia
russia: Flag for Russia
rwanda: Flag for Rwanda
saudi-arabia: Flag for Saudi Arabia
solomon-islands: Flag for Solomon Islands
seychelles: Flag for Seychelles
sudan: Flag for Sudan
sweden: Flag for Sweden
singapore: Flag for Singapore
st-helena: Flag for St. Helena
slovenia: Flag for Slovenia
svalbard-jan-mayen: Flag for Svalbard & Jan Mayen
sierra-leone: Flag for Sierra Leone
san-marino: Flag for San Marino
senegal: Flag for Senegal
somalia: Flag for Somalia
suriname: Flag for Suriname
south-sudan: Flag for South Sudan
sao-tome-principe: Flag for Sao Tome & Principe
el-salvador: Flag for El Salvador
sint-maarten: Flag for Sint Maarten
syria: Flag for Syria
swaziland: Flag for Swaziland
tristan-da-cunha: Flag for Tristan da Cunha
turks-caicos-islands: Flag for Turks & Caicos Islands
chad: Flag for Chad
french-southern-territories: Flag for French Southern Territories
togo: Flag for Togo
thailand: Flag for Thailand
tajikistan: Flag for Tajikistan
timor-leste: Flag for Timor-Leste
turkmenistan: Flag for Turkmenistan
tunisia: Flag for Tunisia
tonga: Flag for Tonga
turkey: Flag for Turkey
trinidad-tobago: Flag for Trinidad & Tobago
tuvalu: Flag for Tuvalu
taiwan: Flag for Taiwan
tanzania: Flag for Tanzania
ukraine: Flag for Ukraine
uganda: Flag for Uganda
us-outlying-islands: Flag for U.S. Outlying Islands
united-states: Flag for United States
uruguay: Flag for Uruguay
uzbekistan: Flag for Uzbekistan
vatican-city: Flag for Vatican City
st-vincent-grenadines: Flag for St. Vincent & Grenadines
venezuela: Flag for Venezuela
british-virgin-islands: Flag for British Virgin Islands
us-virgin-islands: Flag for U.S. Virgin Islands
vietnam: Flag for Vietnam
vanuatu: Flag for Vanuatu
wallis-futuna: Flag for Wallis & Futuna
samoa: Flag for Samoa
yemen: Flag for Yemen
mayotte: Flag for Mayotte
south-africa: Flag for South Africa
zambia: Flag for Zambia
zimbabwe: Flag for Zimbabwe

