new-year: Capodanno
new-year-ru: Capodanno in Russia
fifa-world-cup: coppa del mondo FIFA
chinese-new-year: Capodanno cinese
valentine-day: San Valentino
23-february: Difensore della Giornata della Patria in Russia
maslenica: Shrovetide - La vacanza slava dell'inizio della primavera
8-march: Giornata internazionale della donna
saint-patricks-day: Festa di San Patrizio
holi: Holi - Festival dei colori in India
april-fools-day: Chilm's Day
cosmonautics-day: Giornata della cosmonautica
easter-catolic: Cattolico di Pasqua
easter-orthodox: Pasqua ortodossa
1-may: Festa della primavera e del lavoro in Russia
cinco-de-mayo: Chinko de Mayo
victory-day: Giorno della vittoria in Russia
uefa-champions-league: Champions League UEFA
international-childrens-day: Giornata internazionale dei bambini
eid-al-fitr: Kurban Bayram
dragon-boat-festival: Dragon Boat Festival
queens-official-birthday: Il compleanno ufficiale della regina nel Regno Unito
graduation: Diploma di scuola superiore
independence-day: Giorno dell'Indipendenza negli Stati Uniti
uefa-european-championship: Campionato europeo UEFA
international-chess-day: Giornata internazionale degli scacchi
bastille-day: Giorno della Bastiglia
navy-day: Giornata della Marina in Russia
den-vdv: Giorno delle forze aeree in Russia
knowledge-day: Giorno della conoscenza in Russia
birthday-of-the-smiley: Il compleanno di Smiley
oktoberfest: Festa di ottobre
diwali: Dili
halloween: Halloween
day-of-the-dead: Il giorno dei morti
guy-fawkes-night: Guy Fox Night
thanksgiving: Giorno del Ringraziamento negli Stati Uniti
black-friday: Venerd√¨ nero
hanukkah: Hanukkah
christmas: Natale
summer-olympic-games: Giochi olimpici estivi
winter-olympic-games: Giochi olimpici invernali


new-year-date: Oggi, 1 gennaio
winter-olympic-games-date: Oggi, 4 febbraio
valentine-day-date: Oggi, 14 febbraio
8-march-date: Oggi, 8 marzo
saint-patricks-day-date: Oggi, 17 marzo
april-fools-day-date: Oggi, 1 aprile
easter-catolic-date: Oggi, 17 aprile
1-may-date: Oggi, 1 maggio
eid-al-fitr-date: Oggi, 21 aprile
victory-day-date: Oggi, 9 maggio
uefa-champions-league-date: Oggi, 28 maggio
international-childrens-day-date: Oggi, 1 giugno
international-chess-day-date: Oggi, 20 luglio
birthday-of-the-smiley-date: Oggi, 19 settembre
oktoberfest-date: Oggi, 19 settembre
halloween-date: Oggi, 31 ottobre
fifa-world-cup-date: Oggi, 21 novembre
hanukkah-date: Oggi, 18 dicembre
christmas-date: Oggi, 25 dicembre
