new-year: Nowy Rok
new-year-ru: Nowy Rok w Rosji
fifa-world-cup: Puchar Świata FIFA
chinese-new-year: Chiński Nowy Rok
valentine-day: Walentynki
23-february: Obrońca Dzień Ojczyzny w Rosji
maslenica: Kontrolowe - słowiańskie święto początku wiosny
8-march: Międzynarodowy Dzień Kobiet
saint-patricks-day: Dzień Świętego Patryka
holi: Holi - Festiwal kolorów w Indiach
april-fools-day: Dzień głupca
cosmonautics-day: Dzień kosmonautyki
easter-catolic: Wielkanocny katolik
easter-orthodox: Wielkanoc ortodoksyjny
1-may: Święto wiosny i siły roboczej w Rosji
cinco-de-mayo: Chinko de Mayo
victory-day: Dzień Zwycięstwa w Rosji
uefa-champions-league: Liga Mistrzów UEFA
international-childrens-day: Międzynarodowy Dzień Dzieci
eid-al-fitr: Kurban Bayram
dragon-boat-festival: Święto Smoczych Łodzi
queens-official-birthday: Oficjalne urodziny królowej w Wielkiej Brytanii
graduation: Ukończenie liceum
independence-day: Dzień Niepodległości w USA
uefa-european-championship: Mistrzostwa Europy UEFA
international-chess-day: Międzynarodowy Dzień Szachy
bastille-day: Dzień Bastylii
navy-day: Dzień Marynarki Wojennej w Rosji
den-vdv: Dzień sił powietrznych w Rosji
knowledge-day: Dzień wiedzy w Rosji
birthday-of-the-smiley: Urodziny Smileya
oktoberfest: Październik
diwali: Dili
halloween: Halloween
day-of-the-dead: Dzień śmierci
guy-fawkes-night: Guy Fox Night
thanksgiving: Święto Dziękczynienia w USA
black-friday: Czarny Piątek
hanukkah: Chanukka
christmas: Boże Narodzenie
summer-olympic-games: Letnie Igrzyska Olimpijskie
winter-olympic-games: Zimowe igrzyska olimpijskie


new-year-date: Dzisiaj 1 stycznia
winter-olympic-games-date: Dzisiaj 4 lutego
valentine-day-date: Dzisiaj 14 lutego
8-march-date: Dzisiaj 8 marca
saint-patricks-day-date: Dzisiaj 17 marca
april-fools-day-date: Dzisiaj 1 kwietnia
easter-catolic-date: Dzisiaj 17 kwietnia
1-may-date: Dzisiaj 1 maja
eid-al-fitr-date: Dzisiaj, 21 kwietnia
victory-day-date: Dzisiaj, 9 maja
uefa-champions-league-date: Dzisiaj, 28 maja
international-childrens-day-date: Dzisiaj 1 czerwca
international-chess-day-date: Dzisiaj, 20 lipca
birthday-of-the-smiley-date: Dzisiaj 19 września
oktoberfest-date: Dzisiaj 19 września
halloween-date: Dzisiaj 31 października
fifa-world-cup-date: Dzisiaj 21 listopada
hanukkah-date: Dzisiaj 18 grudnia
christmas-date: Dzisiaj 25 grudnia
