winter-olympic-games: Téli olimpiai játékok
summer-olympic-games: Nyári olimpiai játékok 2020
fifa-world-cup: Labdarúgó-világbajnokság
new-year: Újév
valentine-day: Bálint-nap
8-march: Nemzetközi nőnap
saint-patricks-day: Szent Patrik napja
april-fools-day: Április bolondja
1-may: A munka ünnepe
victory-day: A győzelem napja: május 9
eid-al-fitr: A böjt megtörésének ünnepe
uefa-champions-league: UEFA-bajnokok ligája
international-childrens-day: Gyermeknap
international-chess-day: Nemzetközi sakknap
birthday-of-the-smiley: A mosolygó születésnapja
halloween: Halloween
hanukkah: Hanuka
christmas: Karácsony
oktoberfest: Oktoberfest
easter-catolic: Húsvét
uefa-european-championship: Labdarúgó-Európa-bajnokság

new-year-date: Ma, január 1 -jén
winter-olympic-games-date: Ma, február 4 -én
valentine-day-date: Ma, február 14 -én
8-march-date: Ma, március 8 -án
saint-patricks-day-date: Ma, március 17 -én
april-fools-day-date: Ma, április 17 -én
easter-catolic-date: Ma, március 17 -én
1-may-date: Ma, május 1 -jén
eid-al-fitr-date: Ma, május 2 -án
victory-day-date: Ma, május 9 -én
uefa-champions-league-date: Ma, május 28 -án
international-childrens-day-date: Ma, június 1 -jén
international-chess-day-date: Ma, július 20 -án
birthday-of-the-smiley-date: Ma, szeptember 19 -én
oktoberfest-date: Ma, szeptember 19 -én
halloween-date: Ma, október 31 -én
fifa-world-cup-date: Ma, november 21 -én
hanukkah-date: Ma, december 18 -án
christmas-date: Ma, december 25 -én
