title: Letras de lujo
list_title: Letras de lujo

square: Letras mayúsculas latinas en cuadrado
old-english: Alfabeto inglés de estilo antiguo
runic: Alfabeto inglés de estilo rúnico

latin: Latín
circle: Letras mayúsculas latinas en círculo
lla: Letra A
llb: Letra B
llc: Letra C
lld: Letra D
lle: Letra E
llf: Letra F
llg: Letra G
llh: Letra H
lli: Letra I
llj: Letra J
llk: Letra K
lll: Letra L
llm: Letra M
lln: Letra N
llo: Letra O
llp: Letra P
llq: Letra Q
llr: Letra R
lls: Letra S
llt: Letra T
llu: Letra U
llv: Letra V
llw: Letra W
llx: Letra X
lly: Letra Y
llz: Letra Z