scripts: Scripts
european-scripts: European Scripts
modifier-letters: Modifier Letters
combining-marks: Combining Marks
miscellaneous: Miscellaneous
african-scripts: African Scripts
middle-eastern-scripts: Middle Eastern Scripts
central-asian-scripts: Central Asian Scripts
south-asian-scripts: South Asian Scripts
southeast-asian-scripts: Southeast Asian Scripts
indonesian-philippine: Indonesian & Philippine Scripts
east-asian-scripts: East Asian Scripts
american-scripts: American Scripts

symbols-and-punctuation: Symbols and Punctuation
notational-systems: Notational Systems
punctuation: Punctuation
alphanumeric-symbols: Alphanumeric Symbols
technical-symbols: Technical Symbols
numbers-and-digits: Numbers & Digits
mathematical-symbols: Mathematical Symbols
emoji-and-pictographs: Emoji & Pictographs
other-symbols: Other Symbols
specials: Specials
private-use: Private Use
surrogates: Surrogates
noncharacters-in-charts: Noncharacters in Charts

groups.latin-ligatures: Latin Ligatures
groups.chess-checkers-draughts: Chess & Checkers
groups.game-symbols: Game Symbols
groups.controls: Controls
groups.yijing-symbols: Yijing Symbols
groups.yi: Yi
groups.meroitic: Meroitic
groups.linear-b: Linear-b
groups.noncharacters-in-blocks: Noncharacters in blocks
groups.Noncharacters-at-end-of-...: Noncharacters at end of-...