alt-code: Alt codes
name: Nom
symbol: Symbole
html_code: HTML
entity: Entité
your-browser: Votre navigateur
font-view: Inscription du caractère dans différentes polices
char-desc: Signification du symbole
emoji-desc: Signification de Emoji
ideograph-desc: Signification de l'idéographe
unicode-name: nom dans l'Unosode
unicode-number: Numéro dans l'Unicode
html-code: <span class="caps">HTML</span>-code
css-code: CSS
uppercase: majuscule
lowercase: minuscules
encoding: Codage
related: Symboles ressemblants
tech-info: Information technique
copy: Copiez et collez le symbole
copy-code: Cliquez pour copier
copy_button: Copie
copy_done: Copié!
version: Version Unicode
collections-with-this-symbol: Ensembles avec ce symbole
empty-symbol: Caractère non défini en Unicode
image-not-defined: Image pour le symbole non défini
emoji_group: Catégorie d'Emoji
emoji_version: Version d'Emoji
download: Télécharger
displaying: Affichage du symbole
symbol_not_displayed: Pourquoi le symbole n'est-il pas affiché?
examples: Exemples d'utilisation
synonyms: Synonymes
in-development: Est en développement
show-more: Montre plus
show-less: Montrer moins
