smileys-people: Emotikony i ludzie
animals-nature: Zwierzęta i przyroda
food-drink: Jedzenie picie
activity: Czynność
travel-places: Podróże i miejsca
objects: Obiekty
symbols: Symbolika
flags: Flagi
unsorted: Nieposortowany
currency: Waluta
smileys-and-emotion: Emotikony i emocje
face-smiling: Uśmiechnięta twarz
face-affection: Kochliwa twarz (uczucie)
face-tongue: Twarz z językiem
face-hand: Twarz ręką
face-neutral-skeptical: Neutralna i sceptyczna twarz
face-sleepy: Senna twarz
face-unwell: Chora twarz
face-hat: Twarz w kapeluszu
face-glasses: Twarz w okularach
face-concerned: Zaniepokojona twarz
face-negative: Zła twarz
face-costume: Fantazyjny kostium
cat-face: Kocia twarz
monkey-face: Twarz małpy
emotion: Emocja
people-and-body: Ludzie i ciało
hand-fingers-open: Otwarta dłoń z palcami
hand-fingers-partial: Częściowa ręka z palcami
hand-single-finger: Dłoń z jednym palcem
hand-fingers-closed: Zamknięta dłoń z palcami
hands: Ręce
hand-prop: Właściwości dłoni
body-parts: Części ciała
person: Osoba
person-gesture: Gest osoby
person-role: Rola osoby
person-fantasy: Fantazja i bajka
person-activity: Aktywność osoby
person-sport: Osoba uprawiająca sport
person-resting: Odpoczywająca osoba
family: Rodzina
person-symbol: Symbol osoby
component: Składnik
skin-tone: Odcień skóry
hair-style: Fryzura
animals-and-nature: Zwierzęta i przyroda
animal-mammal: Ssak
animal-bird: Ptak
animal-amphibian: Płaz
animal-reptile: Gad
animal-marine: Zwierzę morskie
animal-bug: Pluskwa
plant-flower: Kwiat
plant-other: Inne rośliny
food-and-drink: Jedzenie picie
food-fruit: Owoc
food-vegetable: Warzywo
food-prepared: Przygotowane jedzenie
food-asian: Azjatyckie jedzenie
food-marine: Owoce morza
food-sweet: Słodkie jedzenie
drink: Napoje
dishware: Naczynia
travel-and-places: Podróże i miejsca
place-map: Mapa
place-geographic: Miejsce geograficzne
place-building: Budynek
place-religious: Miejsce religijne
place-other: Inne miejsca
transport-ground: Transportu naziemnego
transport-water: Transport wodny
transport-air:Transport lotniczy
hotel: Hotel
time: Czas
sky-and-weather: Niebo i pogoda
activities: Zajęcia
event: Zdarzenie
award-medal: Medal i nagroda
sport: Sport
game: Gra
arts-and-crafts: Sztuka i Rękodzieło
clothing: Odzież
sound: Dźwięk
music: Muzyka
musical-instrument: Instrument muzyczny
phone: Telefon
computer: Komputer
light-and-video: Światło i wideo
book-paper: Papierowa książka
money: Pieniądze
mail: Poczta
writing: Pisanie
office: Gabinet
lock: Zamek
tool: Narzędzie
science: Nauka
medical: Medyczny
household: Gospodarstwo domowe
other-object: Inne przedmioty
transport-sign: Znak transportu
warning: Ostrzeżenie
arrow: Strzałka
religion: Religia
zodiac: Zodiak
av-symbol: Symbol AV
gender: Płeć
math: Matematyka
punctuation: Interpunkcja
other-symbol: Inne symbole
keycap: Keycap
alphanum: Alfanumeryczny
geometric: Geometryczny
flag: Flaga
country-flag: Flaga państwa
subdivision-flag: Flaga podziału
smileys-and-emotion: Emotikony i emocje
people-and-body: Ludzie i ciało
component: Składnik
animals-and-nature: Zwierzęta i przyroda
food-and-drink: Jedzenie picie
travel-and-places: Podróże i miejsca
activities: Zajęcia
objects: Obiekty
symbols: Symbolika
flags: Flagi