emotion: Emocja

joy: Uśmiechnięta twarz
love: Miłosna twarz
embarrassment: Nieśmiała twarz
sympathy: Zaniepokojony twarz
discontent: Podrażniona twarz
аnger: Zła lub zirytowana twarz
sadness: Smutna mina
pain: Cierpiąca twarz
fear: Przestraszona twarz
indifference: Sceptyczna twarz
confusion: Zakłopotana twarz
doubt: Podejrzana twarz
surprise: Zaskoczona twarz
sleeping: Śpiąca twarz
nosebleed: Bolesna twarz


animals: Zwierzęta i owady

cats: Twarze kota
dog: Twarze psów
bears: Niedźwiedź twarze
rabbits: Twarze królika
pig: Twarze wieprzowe
bird: Pisklę
fish: Ryba
spider: Pająk


actions: Zajęcia

greeting: Powitać
hug: Przytulać
wink: Flirt
apologizing: Przepraszać
hiding: Ukrywać
writing: Pisać
running: Biegać
music: Śpiewać i tańczyć
games: Bawić się
food: Jeść i pić
friends: Być przyjaciółmi
enemies: Bądź wrogami
weapons: Strzelać
magic: Czy magia
