title: Lettere di fantasia
list_title: Lettere di fantasia

square: Lettere latine quadrate
old-english: Alfabeto inglese vecchio stile
runic: Alfabeto inglese in stile runico

latin: Latino
circle: Letterae maiuscole latine cerchiate
lla: Lettera A
llb: Lettera B
llc: Lettera C
lld: Lettera D
lle: Lettera E
llf: Lettera F
llg: Lettera G
llh: Lettera H
lli: Lettera I
llj: Lettera J
llk: Lettera K
lll: Lettera L
llm: Lettera M
lln: Lettera N
llo: Lettera O
llp: Lettera P
llq: Lettera Q
llr: Lettera R
lls: Lettera S
llt: Lettera T
llu: Lettera U
llv: Lettera V
llw: Lettera W
llx: Lettera X
lly: Lettera Y
llz: Lettera Z