title: Beautiful Letters
list_title: Beautiful Letters
cyrillic: Cyrillic
la: Letter А
lb: Letter Б
lv: Letter В
lg: Letter Г
ld: Letter Д
le: Letter Е
lzh: Letter Ж
lz: Letter З
li: Letter И
ly: Letter Й
lk: Letter К
ll: Letter Л
lm: Letter М
ln: Letter Н
lo: Letter О
lp: Letter П
lr: Letter Р
ls: Letter С
lt: Letter Т
lu: Letter У
lf: Letter Ф
lh: Letter Х
lc: Letter Ц
lch: Letter Ч
lsh: Letter Ш
lsch: Letter Щ
ltvzn: Letter Ъ
lyy: Letter Ы
lmzn: Letter Ь
lye: Letter Э
lyu: Letter Ю
lya: Letter Я
latin: Latin
circle: Circled latin capital letters
square: Squared latin capital letters
lla: Letter A
llb: Letter B
llc: Letter C
lld: Letter D
lle: Letter E
llf: Letter F
llg: Letter G
llh: Letter H
lli: Letter I
llj: Letter J
llk: Letter K
lll: Letter L
llm: Letter M
lln: Letter N
llo: Letter O
llp: Letter P
llr: Letter R
lls: Letter S
llt: Letter T
llu: Letter U
llv: Letter V
llw: Letter W
llx: Letter X
lly: Letter Y
llz: Letter Z
old-english: Beautiful old style english alphabet
runic: Beautiful runic style english alphabet