alt-code: Código Alt
name: Nombre
symbol: Símbolo
html_code: Código HTML
entity: Entidad
your-browser: Su navegador
font-view: Inscripción del caracter en diferentes tipos de letra
char-desc: Significado del símbolo
emoji-desc: Significado de Emoji
ideograph-desc: Significado del ideógrafo
unicode-name: Nombre en Unicode
unicode-number: Número en Unicode
html-code: Código <span class="caps">HTML</span>
css-code: Código CSS
uppercase: Mayúsculas
lowercase: Minúsculas
encoding: Codificación
related: Símbolos relacionados
tech-info: Informacion tecnica
copy: Copia y pega el símbolo
copy-code: Haga clic para copiar
copy_button: Dupdo
copy_done: Copiado!
version: Versión Unicode
collections-with-this-symbol: Conjuntos con este símbolo
empty-symbol: Carácter no definido en Unicode
image-not-defined: La imagen para el símbolo no está definida
emoji_version: Categoría de emoji
emoji_group: Versión de Emoji
download: Descargar
displaying: Mostrar símbolo
symbol_not_displayed: ¿Por qué no se muestra el símbolo?
examples: Ejemplos de uso
synonyms: Sinónimos
in-development: En desarrollo
