smileys-people: Emoticonos y Gente
animals-nature: Animales y Naturaleza
food-drink: Comida y Bebida
activity: Actividades
travel-places: Viajes y Lugares
objects: Objetos
symbols: Símbolos
flags: Banderas
unsorted: Sin Clasificar
currency: Moneda
smileys-and-emotion: Emoticonos y Emociones
face-smiling: Cara sonriente
face-affection: Cara enamorada (afecto)
face-tongue: Cara con lengua
face-hand: Cara con mano
face-neutral-skeptical: Cara neutra y escéptica
face-sleepy: Cara durmiente
face-unwell: Cara enferma
face-hat: Cara con sombrero
face-glasses: Cara con gafas
face-concerned: Cara preocupada
face-negative: Cara enojada
face-costume: Disfraz de fantasía
cat-face: Cara de gato
monkey-face: Cara de mono
emotion: Emoción
people-and-body: Personas y cuerpo
hand-fingers-open: Mano abierta con dedos
hand-fingers-partial: Mano parcial con dedos
hand-single-finger: Mano con un solo dedo
hand-fingers-closed: Mano cerrada con dedos
hands: Manos
hand-prop: Propiedades de mano
body-parts: Partes de cuerpo
person: Persona
person-gesture: Gesto de persona
person-role: Rol de persona
person-fantasy: Persona de fantasía
person-activity: Actividad de persona
person-sport: Persona haciendo deporte
person-resting: Persona descansando
family: Familia
person-symbol: Símbolo de persona
component: Componente
skin-tone: Tono de piel
hair-style: Estilo de pelo
animals-and-nature: Animales y Naturaleza
animal-mammal: Mamífero
animal-bird: Pájaro
animal-amphibian: Anfibios
animal-reptile: Reptil
animal-marine: Animal marino
animal-bug: Insecto
plant-flower: Flor
plant-other: Otras plantas
food-and-drink: Comida y bebida
food-fruit: Fruta
food-vegetable: Verduras
food-prepared: Comida preparada
food-asian: Comida asiática
food-marine: Mariscos
food-sweet: Comida dulce
drink: Beber
dishware: Vajilla
travel-and-places: Viajes y Lugares
place-map: Mapa
place-geographic: Lugar geográfico
place-building: Edificio
place-religious: Lugar religioso
place-other: Otros lugares
transport-ground: Transporte terrestre
transport-water: Transporte de agua
transport-air: Transporte aéreo
hotel: Hotel
time: Hora
sky-and-weather: Cielo y Tiempo
activities: Ocupaciones
event: Evento
award-medal: Medal & Award
sport: Deporte
game: Juego
arts-and-crafts: Arte y Artesanía
clothing: Ropa
sound: Sonido
music: Música
musical-instrument: Instrumento musical
phone: Teléfono
computer: Computadora
light-and-video: Luz y Vídeo
book-paper: Libro de papel
money: Dinero
mail: Correo
writing: Escritura
office: Oficina
lock: Bloquear
tool: Herramienta
science: Ciencias
medical: Medicamento
household: Casa
other-object: Otros objetos
transport-sign: Señal de transporte
warning: Advertencia
arrow: Flecha
religion: Religión
zodiac: Zodíaco
av-symbol: Símbolo AV
gender: Género
math: Matemáticas
punctuation: Puntuación
other-symbol: Otros símbolos
keycap: Tecla
alphanum: Símbolo alfanumérico
geometric: Símbolo geométrico
flag: Bandera
country-flag: Bandera de país
subdivision-flag: Bandera de subdivisión
smileys-and-emotion: Emoticonos y Emociones
people-and-body: Personas y Cuerpo
component: Componente
animals-and-nature: Animales y Naturaleza
food-and-drink: Comida y Bebida
travel-and-places: Viajes y Lugares
activities: Ocupaciones
objects: Objetos
symbols: Símbolos
flags: Banderas