emotion: Emoción

joy: Cara sonriente
love: Cara enamorada
embarrassment: Cara tímida
sympathy: Cara preocupada
discontent: Cara irritada
аnger: Cara malvada o descontenta
sadness: Cara triste
pain: Cara de sufrimiento
fear: Cara asustada
indifference: Cara escéptica
confusion: Cara perpleja
doubt: Cara sospechosa
surprise: Cara sorprendida
sleeping: Cara durmiente
nosebleed: Cara dolorosa


animals: Animales e insectos

cats: Cara de gato
dog: Cara de perro
bears: Cara de oso
rabbits: Cara de conejo
pig: Cara de cerdo
bird: Polito
fish: Pez
spider: Araña


actions: Ocupaciones

greeting: Saludar
hug: Abrazo
wink: Coquetear
apologizing: Pedir disculpas
hiding: Esconder
writing: Escribir
running: Correr
music: Cantar y bailar
games: Jugar
food: Comer y beber
friends: Ser amigos
enemies: Ser enemigos
weapons: Disparo
magic: Hacer magia
