smileys-people: Smileys & People
animals-nature: Animals & Nature
food-drink: Food & Drink
activity: Activity
travel-places: Travel & Places
objects: Objects
symbols: Symbols
flags: Flags
unsorted: Unsorted
currency: Currency
smileys-and-emotion: Smileys & Emotion
face-smiling: Smiling face
face-affection: Amorous face (affection)
face-tongue: Face with tongue
face-hand: Face with hand
face-neutral-skeptical: Neutral and skeptical face
face-sleepy: Sleepy face
face-unwell: Sickly face
face-hat: Face with hat
face-glasses: Face with glasses
face-concerned: Concerned face
face-negative: Angry face
face-costume: Fancy costume
cat-face: Cat face
monkey-face: Monkey face
emotion: Emotion
people-and-body: People & Body
hand-fingers-open: Open hand with fingers
hand-fingers-partial: Partial hand with fingers
hand-single-finger: Hand with single finger
hand-fingers-closed: Closed hand with fingers
hands: Hands
hand-prop: Hand properties
body-parts: Body parts
person: Person
person-gesture: Person gesture
person-role: Person role
person-fantasy: Fantasy and fairy tale person
person-activity: Person activity
person-sport: Person doing sport
person-resting: Resting person
family: Family
person-symbol: Person symbol
component: Component
skin-tone: Skin tone
hair-style: Hair style
animals-and-nature: Animals & Nature
animal-mammal: Mammal
animal-bird: Bird
animal-amphibian: Amphibian
animal-reptile: Reptile
animal-marine: Marine animal
animal-bug: Bug
plant-flower: Flower
plant-other: Other plants
food-and-drink: Food & Drink
food-fruit: Fruit
food-vegetable: Vegetable
food-prepared: Prepared food
food-asian: Asian food
food-marine: Sea food
food-sweet: Sweet food
drink: Drink
dishware: Dishware
travel-and-places: Travel & Places
place-map: Map
place-geographic: Geographic place
place-building: Building
place-religious: Religious place
place-other: Other places
transport-ground: Ground transport
transport-water: Water transport
transport-air: Air transport
hotel: Hotel
time: Time
sky-and-weather: Sky & Weather
activities: Activities
event: Event
award-medal: Medal & Award
sport: Sport
game: Game
arts-and-crafts: Arts & Crafts
clothing: Clothing
sound: Sound
music: Music
musical-instrument: Musical instrument
phone: Phone
computer: Computer
light-and-video: Light & Video
book-paper: Paper book
money: Money
mail: Mail
writing: Writing
office: Office
lock: Lock
tool: Tool
science: Science
medical: Medical
household: Household
other-object: Other objects
transport-sign: Transport sign
warning: Warning
arrow: Arrow
religion: Religion
zodiac: Zodiac
av-symbol: AV symbol
gender: Gender
math: Math
punctuation: Punctuation
other-symbol: Other symbols
keycap: Keycap
alphanum: Alphanumeric
geometric: Geometric
flag: Flag
country-flag: Country flag
subdivision-flag: Subdivision flag
smileys-and-emotion: Smileys & Emotion
people-and-body: People & Body
component: Component
animals-and-nature: Animals & Nature
food-and-drink: Food & Drink
travel-and-places: Travel & Places
activities: Activities
objects: Objects
symbols: Symbols
flags: Flags