emotion: Emotion

joy: Smiling face
love: Face in love
embarrassment: Shy face
sympathy: Concerned face
discontent: Irritated face
Ð°nger: Evil or annoyed face
sadness: Sad face
pain: Suffering face
fear: Frightened face
indifference: Skeptical face
confusion: Perplexed face
doubt: Suspicious face
surprise: Surprised face
sleeping: Sleepy face
nosebleed: Painful face


animals: Animals and insects

cats: Cat face
dog: Dog face
bears: Bear face
rabbits: Rabbit face
pig: Pig face
bird: Chick
fish: Fish
spider: Spider


actions: Activities

greeting: Greet
hug: Hug
wink: Flirt
apologizing: Apologize
hiding: Hide
writing: Write
running: Run
music: Sing and dance
games: Play
food: Eat and drink
friends: Be friends
enemies: Be enemies
weapons: Shoot
magic: Do magic

[kaomoji]: Kaomoji
h1: Kaomoji