alt-code: รหัส Alt
name: ชื่อ
symbol: สัญญลักษณ์
html_code: รหัส HTML
entity: เอนทิตี
your-browser: เบราว์เซอร์ ของคุณ
font-view: จารึก ของตัวละคร ในแบบอักษรที่ แตกต่างกัน
char-desc: ความหมายสัญลักษณ์
emoji-desc: ความหมายอิโมจิ
ideograph-desc: ความหมายเชิงอุดมคติ
unicode-name: ชื่อ Unicode
unicode-number: หมายเลข Unicode
html-code: <span class="caps">โค้ด HTML</span>
css-code: รหัส CSS
# @todo uppercase: ตัวพิมพ์ใหญ่
# @todo lowercase: ตัวพิมพ์เล็ก
# @todo encoding: การเข้ารหัส
related: ตัวละครที่เกี่ยวข้อง
tech-info: ข้อมูลทางเทคนิค
copy: คัดลอกและวางสัญลักษณ์
copy-code: คลิกเพื่อคัดลอก
copy_button: สำเนา
copy_done: คัดลอก!
version: เวอร์ชัน Unicode
collections-with-this-symbol: ชุดที่มีสัญลักษณ์นี้
empty-symbol: อักขระที่ไม่ได้กำหนดไว้ในยูนิโค้ด
image-not-defined: ไม่มีการกำหนดรูปภาพสำหรับสัญลักษณ์
emoji_group: หมวดหมู่ของ Emoji
emoji_version: เวอร์ชั่นของ Emoji
download: ดาวน์โหลด
displaying: แสดงสัญลักษณ์
symbol_not_displayed: ทำไมสัญลักษณ์ไม่แสดง?
examples: ตัวอย่างการใช้งาน
synonyms: คำพ้องความหมาย
in-development: อยู่ในการพัฒนา
show-more: แสดงมากขึ้น
show-less: แสดงน้อยลง
keyboard-shortcut: ปุ่มลัด
escape-sequence: ลำดับการหลบหนี
