title-aside: คาโอโมจิ

[kaomoji]: คาโอโมจิ
h1: คาโอโมจิ

[emotions]: อารมณ์
h1: อารมณ์

joy: ใบหน้ายิ้มแย้ม
love: เผชิญหน้ากับความรัก
embarrassment: หน้าขี้อาย
sympathy: หน้ากังวล
discontent: ใบหน้าที่ระคายเคือง
аnger: ใบหน้าที่ชั่วร้ายหรือรำคาญ
sadness: หน้าเศร้า
pain: ความทุกข์
fear: ใบหน้าที่หวาดกลัว
indifference: หน้าสงสัย
confusion: ใบหน้าที่งุนงง
doubt: ใบหน้าที่น่าสงสัย
surprise: ใบหน้าที่ประหลาดใจ
sleeping: หน้าง่วงนอน
nosebleed: ใบหน้าที่เจ็บปวด

[animals-and-insects]: สัตว์และแมลง
h1: สัตว์และแมลง

cats: ใบหน้าแมว
dog: หน้าสุนัข
bears: หน้าหมี
rabbits: หน้ากระต่าย
pig: ใบหน้าหมู
bird: เจี๊ยบ
fish: ปลา
spider: แมงมุม

[activities-and-activities]: กิจกรรม
h1: กิจกรรม

greeting: ทักทาย
hug: กอด
wink: เจ้าชู้
apologizing: ขอโทษ
hiding: ซ่อน
writing: เขียน
running: วิ่ง
music: ร้องเพลงและเต้นรำ
games: เล่น
food: กินและดื่ม
friends: เป็นเพื่อน
enemies: เป็นศัตรู
weapons: ยิง
magic: ทำเวทมนตร์
table-flipping: พลิกโต๊ะ
