arab: 阿拉伯字母表

armenian: 亞美尼亞字母表

avestan: 阿维斯塔字母表

balinese: 巴厘字母表

bamum: Bamum 字母表

bashkir: 巴什基尔字母表

bassa-vah: Bassa-vah 字母表

batak: 巴塔克字母表

belarusian: 白俄罗斯字母表

bengali: 孟加拉文

bopomofo: 汉语拼音字母表. 注音符號

brahmi: 婆罗米文字母表

buginese: Buginese 字母表

buhid: Buhid 字母表

bulgarian: 保加利亚语字母表

carian: 卡里安字母表

caucasian-albanian: 高加索阿尔巴尼亚字母表

chakma: Chakma字母表

cham: 占語字母

cherokee: 切诺基字母表

chinese: 汉语拼音字母表

coptic: 科普特字母

cypriot-syllabary: 塞浦路斯音節文字

cyrillic: 西里尔字母

czech: 捷克字母表

deseret: Deseret字母表

devanagari: 天城文

elbasan: 爱尔巴桑字母表

english: 英文字母

esperanto: 世界语字母表
	
ethiopic: Ethiopic Ge'ez字母表
	
french: 法语字母
	
georgian: 格鲁吉亚字母表
	
german: 德语字母表
	
glagolitic: Glagolitic字母表
	
gothic: 哥特式字母表
	
grantha: 格兰莎字母表
	
greek: 希腊字母表
	
gujarati: 古吉拉特语字母表
	
gurmukhi: Gurmukhi字母表
	
hangul: 韩文字母
	
hanunoo: Hanunoo字母表
	
hebrew: 希伯来语字母表
	
hungarian: 匈牙利字母表
	
imperial-aramaic: 帝国的aramaic字母表
	
international-phonetic-alphabet: 国际音标
	
italian: 意大利字母
	
japanese-hiragana: 日本平假名字母表
	
japanese-katakana: 日本片假名字母表
	
javanese: 爪哇字母表
	
kaithi: Kaithi字母表
	
kannada: 卡纳达语字母表
	
kayah-li: Kayah li字母表
	
kazakh: 哈萨克字母
	
kharoshthi: Kharoshthi字母表
	
khmer: 高棉字母表
	
khojki: Khojki字母表
	
khudawadi: Khudawadi字母表
	
lao: 老挝字母表
	
latin: 拉丁字母
	
lepcha: Lepcha字母表
	
limbu: Limbu字母表
	
linear-b-Syllabary: 线性B音节
	
lisu: Lisu字母表
	
lycian: 利西亚字母表
	
lydian: Lydian字母表
	
nabataean: Nabataean字母表
	
mahajani: Mahajani字母表
	
malayalam: 马拉雅拉姆语字母表
	
mandaic: 曼达克字母表
	
manichaean: 摩尼教的字母表
	
meetei-mayek: Meetei mayek字母表
	
mende-kikakui: 门德kikakui字母表
	
meroitic-cursive: Meroitic草书字母
	
modi: 莫迪字母表
	
mongolian: 蒙古字母表
	
mro: Mro字母表
	
myanmar: 缅甸字母表
	
new-tai-lue: 新泰语字母表
	
nko: Nko字母表
	
ogham: Ngham字母表
	
ol-chiki: Ol chiki字母表
	
old-italic: 老斜体的etruscan字母表
	
old-north-arabian: 老北阿拉伯字母表
	
old-permic: 老permic字母表
	
old-persian: 老波斯语字母表
	
old-south-arabian: 老南阿拉伯字母表
	
old-turkic: 老土耳其语古代字母表
	
oriya: 奥里亚字母表
	
osmanya: Osmanya字母表
	
pahawh-hmong: Pahawh hmong字母表
	
pahlavi: 巴列维字母表
	
palmyrene: Palmyrene字母表
	
pau-cin-hau: Pau cin hau字母表
	
phags-pa: Phags-pa字母表
	
phoenician: 腓尼基字母表
	
polish: 波兰字母表
	
pollard: 波拉德字母
	
rejang: Rejang字母表
	
runic: 符文字母
	
russian: 俄语字母
	
samaritan: 撒玛利亚字母表
	
saurashtra: Saurashtra字母表
	
sharada: 莎拉达字母表
	
shavian: Shavian字母表
	
siddham: Siddham字母表
	
sinhala: 僧伽罗字母表
	
sora-sompeng: 索拉sompeng字母表
	
spanish: 西班牙字母
	
sundanese: Sund他人字母表
	
syloti-nagri: Syloti nagri字母表
	
syriac: 叙利亚语字母表
	
tagalog: 塔加拉族语字母
	
tagbanwa: Tagbanwa字母表
	
tai-le: 泰乐字母表
	
tai-tham: 泰tham字母表
	
tai-viet: 泰维特字母
	
takri: Takri字母表
	
tamil: 泰米尔语字母表
	
tatar: 塔塔尔字母表
	
telugu: 泰卢固语字母表
	
thaana: 塔纳字母表
	
thai: 泰国字母表
	
tibetan: 藏文字母
	
tifinagh: Tifinagh字母表
	
tirhuta: Tirhuta字母表
	
turkish: 土耳其字母
	
ugaritic: Ugaritic字母表
	
ukrainian: 乌克兰字母表
	
unified-canadian-aboriginal-syllabics: 统一加拿大原住民音节
	
vai: Vai音节
	
varang-kshiti: Varang kshiti字母表
	
yi-syllables: 彝语音节
