new-year: Ano Novo
fifa-world-cup: Copa do Mundo FIFA
new-year-ru: Ano Novo na Rússia
chinese-new-year: Ano Novo Chinês
valentine-day: Dia dos Namorados
23-february: Defensor do Dia da Pátria na Rússia
maslenica: Shrovetide - o feriado eslavo do início da primavera
8-march: Dia Internacional da Mulher
saint-patricks-day: Dia de São Patricio
holi: Holi - Festival de Cores na Índia
april-fools-day: Dia da Mentira
cosmonautics-day: Dia Cosmonautics
easter-catolic: Católico de Páscoa
easter-orthodox: Ortodoxo da Páscoa
1-may: Festa da Primavera e Trabalho na Rússia
cinco-de-mayo: Chinko de Mayo
victory-day: Dia da Vitória na Rússia
uefa-champions-league: Liga dos Campeões UEFA
international-childrens-day: Dia Internacional da Criança
eid-al-fitr: KURBAN BAYRAM
dragon-boat-festival: Festival de barcos de dragão
queens-official-birthday: Aniversário oficial da rainha no Reino Unido
graduation: Graduação do ensino médio
independence-day: Dia da Independência nos EUA
uefa-european-championship: Campeonato Europeu da UEFA
international-chess-day: Dia Internacional de Xadrez
bastille-day: Dia da Bastilha
navy-day: Dia da Marinha na Rússia
den-vdv: Dia das Forças Aerotransportadas na Rússia
knowledge-day: Dia do conhecimento na Rússia
birthday-of-the-smiley: O aniversário de Smiley
oktoberfest: Festival de outubro
diwali: Dili
halloween: Dia das Bruxas
day-of-the-dead: O dia da morte
guy-fawkes-night: Guy Fox Night
thanksgiving: Dia de Ação de Graças nos EUA
black-friday: Sexta-feira preta
hanukkah: Hanukkah
christmas: Natal
summer-olympic-games: Jogos olímpicos de verão
winter-olympic-games: Jogos Olímpicos de Inverno


new-year-date: Hoje, 1 de janeiro
winter-olympic-games-date: Hoje, 4 de fevereiro
valentine-day-date: Hoje, 14 de fevereiro
8-march-date: Hoje, 8 de março
saint-patricks-day-date: Hoje, 17 de março
april-fools-day-date: Hoje, 1 de abril
easter-catolic-date: Hoje, 17 de abril
1-may-date: Hoje, 1 de maio
eid-al-fitr-date: Hoje, é 21 de abril
victory-day-date: Hoje, 9 de maio
uefa-champions-league-date: Hoje, 28 de maio
international-childrens-day-date: Hoje, 1 de junho
international-chess-day-date: Hoje, 20 de julho
birthday-of-the-smiley-date: Hoje, 19 de setembro
oktoberfest-date: Hoje, 19 de setembro
halloween-date: Hoje, 31 de outubro
fifa-world-cup-date: Hoje, 21 de novembro
hanukkah-date: Hoje, 18 de dezembro
christmas-date: Hoje, 25 de dezembro
