arab: アラビア語
	
armenian	: アルメニア
	
avestan	: アベスタンの
	
balinese	: バリの
	
bamum	: バウム・
	
bashkir	: バシキール
	
bassa-vah	: バッサーヴァ
	
batak	: バタック
	
belarusian	: ベラルーシ語
	
bengali	: ベンガル語
	
bopomofo	: 注音字母（注音符号）
	
brahmi	: ブラミミ
	
buginese	: ブギ語
	
buhid	: ブヒッド文字
	
bulgarian	: ブルガリア
	
carian	: カリアンの
	
caucasian-albanian	: 白人アルバニアの
	
chakma	: チャクマ
	
cham	: チャム
	
cherokee	: チェロキー
	
chinese	: 中国語ピンイン
	
coptic	: コプティック
	
cypriot-syllabary	: キプロスの音節
	
cyrillic	: キリル文字
	
czech	: チェコ語
	
deseret	: Deseret
	
devanagari	: デファナガリ
	
elbasan	: エルバサンの
	
english	: 英語
	
esperanto	: エスペラント
	
ethiopic	: エチオピアGe'ez
	
french	: フランス語
	
georgian	: グルジアの
	
german	: ドイツ語
	
glagolitic	: グラガリット
	
gothic	: ゴシック
	
grantha	: グランサ
	
greek	: ギリシャ語
	
gujarati	: グジャラート語
	
gurmukhi	: グルムキー
	
hangul	: ハングル
	
hanunoo	: ハヌヌー
	
hebrew	: ヘブライ文字
	
hungarian	: ハンガリー語
	
imperial-aramaic	: 皇帝のアラム語
	
international-phonetic-alphabet	: 国際発音記号
	
italian	: イタリア語
	
japanese-hiragana	: 日本語ひらがな
	
japanese-katakana	: 日本語カタカナ
	
javanese	: ジャワの
	
kaithi	: カイティ
	
kannada	: カンナダ
	
kayah-li	: カヤー文字
	
kazakh	: カザフ語
	
kharoshthi	: カロシティ
	
khmer	: クメール
	
khojki	: コジキ
	
khudawadi	: クダワディ
	
lao	: ラオ語
	
latin	: ラテン
	
lepcha	: Lepcha
	
limbu	: リムブレ
	
linear-b-Syllabary	: リニアB音節
	
lisu	: Lisu
	
lycian	: リシアン
	
lydian	: リディアン
	
nabataean	: ナバタリアン
	
mahajani	: マハジャニ
	
malayalam	: マラヤラムの
	
mandaic	: マンダの
	
manichaean	: マニカイアの
	
meetei-mayek	: マニプリ文字
	
mende-kikakui	: メンデキカクイ
	
meroitic-cursive	: メロエイト筆記体
	
modi	: モディ
	
mongolian	: モンゴル
	
mro	: モロッコ
	
myanmar	: ミャンマー
	
new-tai-lue	: 新しいタイ文字の
	
nko	: 仁子
	
ogham	: ナガム
	
ol-chiki	: オルチキ
	
old-italic	: 古いイタリックエトルリア
	
old-north-arabian	: 旧北部
	
old-permic	: 古いpermic
	
old-persian	: 旧ペルシア語
	
old-south-arabian	: 古い南アラビア人の
	
old-turkic	: 古代トルコ文字の
	
oriya	: オリヤ
	
osmanya	: オスマンヤ
	
pahawh-hmong	: パハウア語の
	
pahlavi	: パレルビ
	
palmyrene	: パルミチン
	
pau-cin-hau	: ポー・シン・ニュー・
	
phags-pa	: Phags-pa
	
phoenician	: フェニシアの
	
polish	: ポーランドの
	
pollard	: ポーランドの
	
rejang	: レジャン
	
runic	: ルニック
	
russian	: ロシア 語 
	
samaritan	: サマリアの
	
saurashtra	: サラシュトラ
	
sharada	: シャラダ
	
shavian	: シャビアン
	
siddham	: シドハム
	
sinhala	: シンハラ
	
sora-sompeng	: ソラ・ムンペング・
	
spanish	: スペイン語の
	
sundanese	: スンダ語
	
syloti-nagri	: シロティ・ナグリ文字
	
syriac	: シリアの
	
tagalog	: タガログ語
	
tagbanwa	: タグバヌア文字の
	
tai-le	: タイの
	
tai-tham	: 太鼓の
	
tai-viet	: タイベイト
	
takri	: タクリ
	
tamil	: タミル語
	
tatar	: タタール
	
telugu	: テルグ語
	
thaana	: タワナ
	
thai	: タイ
	
tibetan	: チベットの
	
tifinagh	: ティフナグ文字
	
tirhuta	: ティルタ
	
turkish	: トルコ語
	
ugaritic	: ウガニア語
	
ukrainian	: ウクライナ語
	
unified-canadian-aboriginal-syllabics	: 統一されたカナダ原住民の音節
	
vai	: 五十音
	
varang-kshiti	: ヴァランクシティ
	
yi-syllables	: イ文字（ロロ文字）