title-aside: 顔文字

[kaomoji]: 顔文字
h1: 顔文字

[emotions]: 感情
h1: 感情

joy: 笑顔
love: 恋に顔
embarrassment: 恥ずかしがり屋の顔
sympathy: 心配の顔
discontent: イライラした顔
аnger: 怒っているまたは不機嫌な顔
sadness: 悲しい顔
pain: 苦しみの顔
fear: おびえた顔
indifference: 懐疑的な顔
confusion: 困惑された顔
doubt: 疑わしい顔
surprise: 驚いた顔
sleeping: 眠い顔
nosebleed: 痛みを伴う顔

[animals-and-insects]: 動物や昆虫
h1: 動物や昆虫

cats: 猫顔
dog: 犬顔
bears: クマの顔
rabbits: ウサギの顔
pig: 豚の顔
bird: ひよこ
fish: 魚
spider: クモ

[activities-and-activities]: 活動
h1: 活動

greeting: 挨拶
hug: 抱擁
wink: イチャイチャ
apologizing: 謝罪
hiding: 隠れる
writing: 書く
running: 走る
music: 歌い踊る
games: 演奏する
food: 飲食する
friends: 友達に
enemies: 敵になる
weapons: シュート
magic: 魔法の
table-flipping: ちゃぶ台返し
