smileys-people: Smileys e Pessoas
animals-nature: Animais e Natureza
food-drink: Alimentação e bebida
activity: Atividade
travel-places: Viagens e lugares
objects: Objetos
symbols: Símbolos
flags: Bandeiras
unsorted: Não triados
currency: Moeda
smileys-and-emotion: Smileys e Emoção
face-smiling: Rosto sorridente
face-affection: Rosto amoroso (carinho)
face-tongue: Rosto com a língua
face-hand: Cara com a mão
face-neutral-skeptical: Face neutra e cética
face-sleepy: Cara de sono
face-unwell: Cara doentia
face-hat: Cara com chapéu
face-glasses: Rosto com óculos
face-concerned: Rosto preocupado
face-negative: Cara de bravo
face-costume: Fantasia
cat-face: Cara de Gato
monkey-face: Cara de macaco
emotion: Emoção
people-and-body: Pessoas e Corpo
hand-fingers-open: Mão aberta com os dedos
hand-fingers-partial: Mão parcial com os dedos
hand-single-finger: Mão com um dedo
hand-fingers-closed: Mão fechada com os dedos
hands: Mãos
hand-prop: Propriedades da mão
body-parts: Partes do corpo
person: Pessoa
person-gesture: Gesto
person-role:  Função
person-fantasy: Pessoa de fantasia e conto de fadas
person-activity: Atividade da pessoa
person-sport: Pessoa fazendo esporte
person-resting: Pessoa em repouso
family: Família
person-symbol: Símbolo pessoa
component: Componente
skin-tone: Tom de pele
hair-style: Penteado
animals-and-nature: Animais e Natureza
animal-mammal: Mamífero
animal-bird: Pássaro
animal-amphibian: Anfíbio
animal-reptile: Réptil
animal-marine: Animal marinho
animal-bug: Erro
plant-flower: Flor
plant-other: Outras plantas
food-and-drink: Alimentação e bebida
food-fruit:  Frutas
food-vegetable: Vegetal
food-prepared: Alimentos preparados
food-asian: Culinária asiática
food-marine: Frutos do mar
food-sweet:  Comida doce
drink: Bebida
dishware: Louça
travel-and-places: Viagens e lugares
place-map: Mapa
place-geographic: Local geográfico
place-building: Edifício
place-religious: Lugar religioso
place-other: Outros lugares
transport-ground:  Transporte terrestre
transport-water: Transporte de água
transport-air: Transporte aéreo
hotel: Hotel
time: Tempo
sky-and-weather: Céu e clima
activities: Atividades
event: Evento
award-medal: Medalha e Prêmio
sport: Esporte
game: Jogos
arts-and-crafts: Artes e Artesanatos
clothing: Roupas
sound: Som
music: Música
musical-instrument: MInstrumento musical
phone: Telefone
computer: Computador
light-and-video: Luz e vídeo
book-paper:  Livro de papel
money: Dinheiro
mail: Enviar
writing: Escrevendo
office: Escritório
lock: Bloquear
tool: Ferramenta
science: Ciência
medical: Médico
household: Uso doméstico
other-object: Outros objetos
transport-sign: Sinal de transporte
warning: Aviso
arrow: Seta
religion: Religião
zodiac: Zodíaco
av-symbol: Símbolo AV
gender: Gênero
math: Matemática
punctuation: Pontuação
other-symbol: Outros símbolos
keycap: Keycap
alphanum: Alfanumérico
geometric: Geométrico
flag: Bandeira
country-flag: Bandeira do país
subdivision-flag: Sinalizador de subdivisão
smileys-and-emotion: Smileys e Emoção
people-and-body: Pessoas e Corpo
component: Componente
animals-and-nature: Animais e Natureza
food-and-drink: Alimentação e bebida
travel-and-places: Viagens e lugares
activities: Atividades
objects: Objetos
symbols: Símbolos
flags: Bandeiras