arab: Arab alfabetul

armenian: Armenesc alfabetul

avestan: Avestică alfabetul

balinese: Balinic alfabetul

bamum: Bamum alfabetul

bashkir: Bașchiră alfabetul

bassa-vah: Bassa-vah alfabetul

batak: Batak alfabetul

belarusian: Belarus alfabetul

bengali: Bengal alfabetul

bopomofo: Bopomofo alfabetul. Zhuyin

brahmi: Brahmi alfabetul

buginese: Buginese alfabetul

buhid: Buhid alfabetul

bulgarian: Bulgar alfabetul

carian: Carabine alfabetul

caucasian-albanian: Caucazian albanez alfabetul

chakma: Chakma alfabetul

cham: Cham alfabetul

cherokee: Cherokee alfabetul

chinese: Chinese Pinyin alfabetul

coptic: Coptic alfabetul

cypriot-syllabary: Cipriot syllabar

cyrillic: Chirilic alfabetul

czech: Ceh alfabetul

deseret: Deseuri alfabetul

devanagari: Devanagari alfabetul

elbasan: Elbasan alfabetul

english: Engleze alfabetul

esperanto: Esperanto alfabetul
	
ethiopic: Ethiopic Ge'ez alfabetul
	
french: Francez alfabetul
	
georgian: Georgian alfabetul
	
german: German alfabetul
	
glagolitic: Glagolitic alfabetul
	
gothic: Gothic alfabetul
	
grantha: Grantha alfabetul
	
greek: Grecesc alfabetul
	
gujarati: Gujarati alfabetul
	
gurmukhi: Gurmukhi alfabetul
	
hangul: Hangulul alfabetul
	
hanunoo: Hanunoo alfabetul
	
hebrew: Ebraic alfabetul
	
hungarian: Maghiară alfabetul
	
imperial-aramaic: Imperial aramaic alfabetul
	
international-phonetic-alphabet: Internațional fonetic alfabetul
	
italian: Italiană alfabetul
	
japanese-hiragana: Hiragana japonez alfabetul
	
japanese-katakana: Japoneză catakana alfabetul
	
javanese: Javanese alfabetul
	
kaithi: Kaithi alfabetul
	
kannada: Kannada alfabetul
	
kayah-li: Kayah li alfabetul
	
kazakh: Kazah alfabetul
	
kharoshthi: Kharoshthi alfabetul
	
khmer: Khmer alfabetul
	
khojki: Khojki alfabetul
	
khudawadi: Khudawadi alfabetul
	
lao: Lao alfabetul
	
latin: Latin alfabetul
	
lepcha: Lepcha alfabetul
	
limbu: Limba alfabetul
	
linear-b-Syllabary: Linear B syllabary
	
lisu: Lisu alfabetul
	
lycian: Lycian alfabetul
	
lydian: Lydian alfabetul
	
nabataean: Nabataean alfabetul
	
mahajani: Mahajani alfabetul
	
malayalam: Malayalam alfabetul
	
mandaic: Mandaic alfabetul
	
manichaean: Manichaean alfabetul
	
meetei-mayek: Metetei Mayek alfabetul
	
mende-kikakui: Mende kikakui alfabetul
	
meroitic-cursive: Mercitic cursiv alfabetul
	
modi: Modi alfabetul
	
mongolian: Mongolă alfabetul
	
mro: Mro alfabetul
	
myanmar: Myanmar alfabetul
	
new-tai-lue: Noua tai lue alfabetul
	
nko: Nko alfabetul
	
ogham: Ngham alfabetul
	
ol-chiki: Ol Chiki alfabetul
	
old-italic: Etrusc al italicului italian  alfabetul
	
old-north-arabian: Vechiul din Arabia de Nord alfabetul
	
old-permic: Vechiul permic alfabetul
	
old-persian: Vechiul persan alfabetul
	
old-south-arabian: Sudic din Arabia de Sud alfabetul
	
old-turkic: Vechiul turcesc turc alfabetul
	
oriya: Oriya alfabetul
	
osmanya: Osmanya alfabetul
	
pahawh-hmong: Pahawh hmong alfabetul
	
pahlavi: Pahlavi alfabetul
	
palmyrene: Palmyrene alfabetul
	
pau-cin-hau: Pau cin hau alfabetul
	
phags-pa: Fage-pa alfabetul
	
phoenician: Fenician alfabetul
	
polish: Polonez alfabetul
	
pollard: Pollard alfabetul
	
rejang: Rejang alfabetul
	
runic: Runică alfabetul
	
russian: Rusesc alfabetul
	
samaritan: Samaritanul alfabetul
	
saurashtra: Saurashtra alfabetul
	
sharada: Sharada alfabetul
	
shavian: Shavian alfabetul
	
siddham: Siddham alfabetul
	
sinhala: Sinhala alfabetul
	
sora-sompeng: Sora sompeng alfabetul
	
spanish: Spaniol alfabetul
	
sundanese: Sundanese alfabetul
	
syloti-nagri: Syloti nagri alfabetul
	
syriac: Siriac alfabetul
	
tagalog: Tagalog alfabetul
	
tagbanwa: Tagbanwa alfabetul
	
tai-le: Tai-le alfabetul
	
tai-tham: Tai-tham alfabetul
	
tai-viet: Tai-viet alfabetul
	
takri: Takri alfabetul
	
tamil: Tamil alfabetul
	
tatar: Tatar alfabetul
	
telugu: Telugu alfabetul
	
thaana: Thaana alfabetul
	
thai: Thai alfabetul
	
tibetan: Tibetan alfabetul
	
tifinagh: Tifinagh alfabetul
	
tirhuta: Tirhuta alfabetul
	
turkish: Turc alfabetul
	
ugaritic: Ugaritic alfabetul
	
ukrainian: Ucrainean alfabetul
	
unified-canadian-aboriginal-syllabics: Unitatea abilitară canadiană unificată
	
vai: Syllabarul Vai
	
varang-kshiti: Varang kshiti alfabetul
	
yi-syllables: Syllabarul Yi
