arab: ตัวอักษรอาหรับ

armenian: ตัวอักษรอาร์มีเนีย

avestan: ตัวอักษรอเวสตะ

balinese: ตัวอักษรบาหลี

bamum: Bamum ตัวอักษร

bashkir: ภาษาแบชเคียร์

bassa-vah: Bassa-vah ตัวอักษร

batak: ตัวอักษรบาตัก

belarusian: ตัวอักษรเบลารุส

bengali: ตัวอักษรเบงกาลี

bopomofo: Bopomofo ตัวอักษร จู้อิน

brahmi: ตัวอักษรพราหมี

buginese: Buginese ตัวอักษร

buhid: Buhid ตัวอักษร

bulgarian: ตัวอักษรบัลแกเรีย

carian: ตัวอักษรคาเรีย

caucasian-albanian: ตัวอักษรคอเคเชี่ยนแอลเบเนีย

chakma: ตัวอักษรจักรี

cham: ตัวอักษรจาม

cherokee: ตัวอักษรเชอโรกี

chinese: พินอินตัวอักษร

coptic: ตัวอักษรคอปติก

cypriot-syllabary: ตัวอักษรไซปรัส

cyrillic: ตัวอักษรซีริลลิก

czech: ตัวอักษรเช็ก

deseret: Deseret ตัวอักษร

devanagari: ตัวอักษรเทวนาครี

elbasan: ตัวอักษรเอลบาซาน

english: ตัวอักษรภาษาอังกฤษ

esperanto: ตัวอักษรภาษาเอสเปรันโต
	
ethiopic: ตัวอักษร Ethiopic Geʻez
	
french: ตัวอักษรภาษาฝรั่งเศส
	
georgian: ตัวอักษรจอร์เจีย
	
german: ตัวอักษรภาษาเยอรมัน
	
glagolitic: ตัวอักษร Glagolitic
	
gothic: ตัวอักษรกอธิค
	
grantha: ตัวอักษร Grantha
	
greek: ตัวอักษรกรีก
	
gujarati: ตัวอักษรคุชราต
	
gurmukhi: ตัวอักษร Gurmukhi
	
hangul: ตัวอักษรอังกูล
	
hanunoo: ตัวอักษร Hanunoo
	
hebrew: ตัวอักษรฮีบรู
	
hungarian: ตัวอักษรฮังการี
	
imperial-aramaic: ตัวอักษรอราเมอิกอิมพีเรียล
	
international-phonetic-alphabet: สัทอักษรสากล
	
italian: ตัวอักษรอิตาลี
	
japanese-hiragana: ฮิระงะนะตัวอักษรญี่ปุ่น
	
japanese-katakana: ตัวอักษรคาตาคานะญี่ปุ่น
	
javanese: ตัวอักษรชวา
	
kaithi: ตัวอักษร Kaithi
	
kannada: ตัวอักษรกั ณ ณาท
	
kayah-li: ตัวอักษร Kayah li
	
kazakh: ตัวอักษรคาซัค
	
kharoshthi: ตัวอักษรคาโรห์ธิ
	
khmer: ตัวอักษรเขมร
	
khojki: ตัวอักษร Khojki
	
khudawadi: ตัวอักษร Khudawadi
	
lao: ตัวอักษรลาว
	
latin: ตัวอักษรละติน
	
lepcha: ตัวอักษร Lepcha
	
limbu: ตัวอักษรลิมบู
	
linear-b-Syllabary: พยางค์ B เชิงเส้น
	
lisu: ตัวอักษรลีซอ
	
lycian: ตัวอักษร Lycian
	
lydian: ตัวอักษร Lydian
	
nabataean: ตัวอักษร Nabataean
	
mahajani: ตัวอักษร Mahajani
	
malayalam: ตัวอักษรมาลายาลัม
	
mandaic: ตัวอักษร Mandaic
	
manichaean: ตัวอักษร Manichaean
	
meetei-mayek: ตัวอักษร Meetei mayek
	
mende-kikakui: ตัวอักษร Mende kikakui
	
meroitic-cursive: ตัวอักษรตัวสะกด Meroitic
	
modi: ตัวอักษร Modi
	
mongolian: ตัวอักษรมองโกเลีย
	
mro: ตัวอักษร Mro
	
myanmar: ตัวอักษรพม่า
	
new-tai-lue: ตัวอักษรไทลื้อใหม่
	
nko: ตัวอักษร Nko
	
ogham: พยัญชนะไทย
	
ol-chiki: ตัวอักษร Ol chiki
	
old-italic: ตัวอักษรอิทรัสตัวเอียงเก่า
	
old-north-arabian: ตัวอักษรภาษาอาหรับทิศตะวันตกเฉียงเหนือเก่า
	
old-permic: ตัวอักษร Permic เก่า
	
old-persian: ตัวอักษรเปอร์เซียโบราณ
	
old-south-arabian: ตัวอักษรอารเบียใต้เก่า
	
old-turkic: ตัวอักษรรูนโบราณของตุรกี
	
oriya: ตัวอักษรโอริยา
	
osmanya: ตัวอักษรออสมันยา
	
pahawh-hmong: ตัวอักษรม้งปะหัง
	
pahlavi: ตัวอักษรปาห์ลาวี
	
palmyrene: ตัวอักษร Palmyrene
	
pau-cin-hau: ตัวอักษร pau cin hau
	
phags-pa: ตัวอักษร Phags-pa
	
phoenician: ตัวอักษรภาษาฟินีเซียน
	
polish: ตัวอักษรโปแลนด์
	
pollard: ตัวอักษร Pollard
	
rejang: ตัวอักษร Rejang
	
runic: ตัวอักษรรูน
	
russian: ตัวอักษรรัสเซีย
	
samaritan: ตัวอักษรพลเมือง
	
saurashtra: ตัวอักษร Saurashtra
	
sharada: ตัวอักษร Sharada
	
shavian: ตัวอักษร Shavian
	
siddham: ตัวอักษร Siddham
	
sinhala: ตัวอักษรสิงหล
	
sora-sompeng: ตัวอักษรโซระสมเพ็ง
	
spanish: ตัวอักษรสเปน
	
sundanese: ตัวอักษรซุนดา
	
syloti-nagri: ตัวอักษร Syloti nagri
	
syriac: ตัวอักษร Syriac
	
tagalog: ตัวอักษรภาษาตากาล็อก
	
tagbanwa: ตัวอักษร Tagbanwa
	
tai-le: ตัวอักษรไทเลอ
	
tai-tham: ตัวอักษรไทแทม
	
tai-viet: ตัวอักษรเวียดนาม
	
takri: ตัวอักษรตะกรี
	
tamil: ตัวอักษรทมิฬ
	
tatar: ตัวอักษรตาตาร์
	
telugu: ตัวอักษรเตลูกู
	
thaana: ตัวอักษรไทย
	
thai: ตัวอักษรไทย
	
tibetan: ตัวอักษรทิเบต
	
tifinagh: ตัวอักษร Tifinagh
	
tirhuta: ตัวอักษร Tirhuta
	
turkish: ตัวอักษรตุรกี
	
ugaritic: ตัวอักษร Ugaritic
	
ukrainian: ตัวอักษรยูเครน
	
unified-canadian-aboriginal-syllabics: พยางค์ดั้งเดิมของแคนาดาเป็นปึกแผ่น
	
vai: พยางค์ Vai
	
varang-kshiti: ตัวอักษร Varang kshiti
	
yi-syllables: ยี่พยางค์
