new-year: ปีใหม่
new-year-ru: ปีใหม่ในรัสเซีย
fifa-world-cup: FIFA World Cup
chinese-new-year: ตรุษจีน, วันปีใหม่จีน
valentine-day: วันวาเลนไทน์
23-february: ผู้พิทักษ์แห่งวันเกิดในรัสเซีย
maslenica: Shrovetide - วันหยุดสลาฟของต้นฤดูใบไม้ผลิ
8-march: วันสตรีสากล
saint-patricks-day: วันเซนต์แพททริค
holi: Holi - เทศกาลสีในอินเดีย
april-fools-day: วันคนโง่
cosmonautics-day: วันแห่งอวกาศ
easter-catolic: อีสเตอร์คาทอลิก
easter-orthodox: อีสเตอร์ออร์โธดอกซ์
1-may: งานเลี้ยงฤดูใบไม้ผลิและแรงงานในรัสเซีย
cinco-de-mayo: Chinko de Mayo
victory-day: วันแห่งชัยชนะในรัสเซีย
uefa-champions-league: แชมเปี้ยนส์ลีกยูฟ่า
international-childrens-day: วันเด็กนานาชาติ
eid-al-fitr: Kurban Bayram
dragon-boat-festival: เทศกาลเรือมังกร
queens-official-birthday: วันเกิดอย่างเป็นทางการของราชินีในสหราชอาณาจักร
graduation: จบการศึกษาระดับมัธยมปลาย
independence-day: วันประกาศอิสรภาพในสหรัฐอเมริกา
uefa-european-championship: ฟุตบอลชิงแชมป์แห่งชาติยุโรป
international-chess-day: วันหมากรุกนานาชาติ
bastille-day: วันบัสตีย์
navy-day: วันกองทัพเรือในรัสเซีย
den-vdv: วันแห่งกองทัพอากาศในรัสเซีย
knowledge-day: วันความรู้ในรัสเซีย
birthday-of-the-smiley: วันเกิดของ Smiley
oktoberfest: ตุลาคม
diwali: ดิลี่
halloween: ฮัลโลวีน
day-of-the-dead: วันแห่งความตาย
guy-fawkes-night: Guy Fox Night
thanksgiving: วันขอบคุณพระเจ้าในสหรัฐอเมริกา
black-friday: Black Friday
hanukkah: ฮานุกกะห์
christmas: คริสต์มาส
summer-olympic-games: การแข่งขันกีฬาโอลิมปิกฤดูร้อน
winter-olympic-games: การแข่งขันกีฬาโอลิมปิกฤดูหนาว


new-year-date: วันนี้ 1 มกราคม
winter-olympic-games-date: วันนี้ 4 กุมภาพันธ์
valentine-day-date: วันนี้ 14 กุมภาพันธ์
8-march-date: วันนี้ 8 มีนาคม
saint-patricks-day-date: วันนี้ 17 มีนาคม
april-fools-day-date: วันนี้ 1 เมษายน
1-may-date: วันนี้ 1 พฤษภาคม
eid-al-fitr-date: วันนี้เป็นวันที่ 21 เมษายน
victory-day-date: วันนี้ 9 พฤษภาคม
uefa-champions-league-date: วันนี้ 28 พฤษภาคม
international-childrens-day-date: วันนี้ 1 มิถุนายน
international-chess-day-date: วันนี้ 20 กรกฎาคม
birthday-of-the-smiley-date: วันนี้ 19 กันยายน
halloween-date: วันนี้ 31 ตุลาคม
fifa-world-cup-date: วันนี้ 21 พฤศจิกายน
hanukkah-date: วันนี้ 18 ธันวาคม
christmas-date: วันนี้ 25 ธันวาคม
