smileys-people: Zâmbete și oameni
animals-nature: Animale și natură
food-drink: Mancare bautura
activity: Activitate
travel-places: Călătorii și locuri
objects: Obiecte
symbols: Simboluri
flags: Steaguri
unsorted: Nesortate
currency: Valută
smileys-and-emotion: Zambete si emotie
face-smiling: Fata zambitoare
face-affection: Față amoroasă (afecțiune)
face-tongue: Față cu limba
face-hand: Față cu mâna
face-neutral-skeptical: Fața neutră și sceptică
face-sleepy: Față adormită
face-unwell: Față bolnavă
face-hat: Față cu pălărie
face-glasses: Față cu ochelari
face-concerned: Față îngrijorată
face-negative: Față furios
face-costume: Costum de lux
cat-face: Fata de pisica
monkey-face: Fata de maimuta
emotion: Emoţie
people-and-body: Oameni și corp
hand-fingers-open: Mâna deschisă cu degetele
hand-fingers-partial: Mână parțială cu degetele
hand-single-finger: Mâna cu un deget
hand-fingers-closed: Mâna închisă cu degetele
hands: Mâinile
hand-prop: Proprietățile mâinii
body-parts: Parti ale corpului
person: Persoană
person-gesture: Gestul persoanei
person-role: Rolul persoanei
person-fantasy: Persoană de fantezie și basm
person-activity: Activitatea persoanei
person-sport: Persoană care face sport
person-resting: Persoana în repaus
family: Familie
person-symbol: Simbolul persoanei
component: Component
skin-tone: Tonul pielii
hair-style: Stilul parului
animals-and-nature: Animale și natură
animal-mammal: Mamifer
animal-bird: Pasăre
animal-amphibian: Amfibian
animal-reptile: Reptila
animal-marine: Animal marin
animal-bug: Gândac
plant-flower: Floare
plant-other:Alte plante
food-and-drink: Mancare bautura
food-fruit: Fructe
food-vegetable: Legume
food-prepared: Mâncare pregătită
food-asian: Mâncare asiatică
food-marine: Mâncare la mare
food-sweet: Mâncarea dulce
drink: Băutură
dishware: Vasa
travel-and-places: Călătorii și locuri
place-map: Hartă
place-geographic: Loc geografic
place-building: Clădire
place-religious: RLoc religios
place-other: Alte locuri
transport-ground: Transport la sol
transport-water: Transport de apă
transport-air: Transport aerian
hotel: Hotel
time: Timp
sky-and-weather: Cerul și vremea
activities: Activități
event: Eveniment
award-medal: Medală și premiu
sport: Sportiv
game: Joc
arts-and-crafts: Arte și meserii
clothing: Îmbrăcăminte
sound: Sunet
music: Muzică
musical-instrument: Instrument muzical
phone: Telefon
computer: Calculator
light-and-video: Lumina și video
book-paper: Carte de hârtie
money: Bani
mail: Poștă
writing: Scris
office: Birou
lock: Lacăt
tool: Instrument
science: Știință
medical: Medicament
household: Gospodărie
other-object:Alte obiecte
transport-sign: Semn de transport
warning: Avertizare
arrow: Săgeată
religion: Religie
zodiac: Zodiac
av-symbol: Simbol AV
gender: Gen
math: Matematică
punctuation: Punctuație
other-symbol:Alte simboluri
keycap: Keycap
alphanum: Alfanumerică
geometric: Forme geometrice
flag: Steag
country-flag: Steagul țării
subdivision-flag: Steagul subdiviziunii
smileys-and-emotion: Zambete si emotie
people-and-body: Oameni și corp
component: Component
animals-and-nature: Animale și natură
food-and-drink: Mancare bautura
travel-and-places: Călătorii și locuri
activities: Activități
objects: Obiecte
symbols: Simboluri
flags: Steaguri