smileys-people: 스마일 및 사람들
animals-nature: 동물과 자연
food-drink: 식음료
activity: 활동
travel-places: 여행 및 장소
objects: 사물
symbols: 기호
flags: 깃발
unsorted: 분류되지 않은
currency: 통화
smileys-and-emotion: 스마일 & 감정
face-smiling: 웃는 얼굴
face-affection: 사랑스러운 얼굴 (애정)
face-tongue:  혀로 얼굴
face-hand: 손으로 얼굴
face-neutral-skeptical: 중립적이고 회의적인 얼굴
face-sleepy: 중립적이고 회의적인 얼굴
face-unwell: 아픈 얼굴
face-hat: 모자와 얼굴
face-glasses: 안경 얼굴
face-concerned: 걱정되는 얼굴
face-negative: 화난 얼굴
face-costume: 멋진 의상
cat-face: 고양이 얼굴
monkey-face: 원숭이 얼굴
emotion: 감정
people-and-body: 사람과 몸
hand-fingers-open: 손가락으로 열린 손
hand-fingers-partial: 손가락으로 부분 손
hand-single-finger:  한 손가락으로 손
hand-fingers-closed: 손가락으로 닫힌 손
hands: 손
hand-prop:손 속성
body-parts:  신체 부위
person: 사람
person-gesture: 몸짓
person-role: 개인 역할
person-fantasy: 환상과 동화 속 인물
person-activity: 개인 활동
person-sport:  스포츠를하는 사람
person-resting: 휴식 사람
family: 가족
person-symbol: 사람 기호
component: 구성 요소
skin-tone: 피부색
hair-style: 헤어 스타일
animals-and-nature: 동물과 자연
animal-mammal: 포유류
animal-bird: 새
animal-amphibian: 양서류
animal-reptile: 파충류
animal-marine:  해양 동물
animal-bug: 벌레
plant-flower: 꽃
plant-other: 다른 식물
food-and-drink: 식음료
food-fruit: 과일
food-vegetable:  야채
food-prepared:준비된 음식
food-asian: 아시아 음식
food-marine:  해물
food-sweet: 달콤한 음식
drink: 음주
dishware: 식기
travel-and-places: 여행 및 장소
place-map: 지도
place-geographic: 지리적 장소
place-building: 건물
place-religious: 종교적인 장소
place-other: 다른 장소
transport-ground: 지상 운송
transport-water: 물 수송
transport-air: 항공 운송
hotel: 호텔
time: 시간
sky-and-weather:  하늘과 날씨
activities: 활동
event: 행사
award-medal: 메달 및 수상
sport: 스포츠
game: 게임
arts-and-crafts: 예술과 공예
clothing: 의류
sound: 소리
music: 음악
musical-instrument: 악기
phone: 전화
computer: 컴퓨터
light-and-video: 라이트 및 비디오
book-paper: 종이 책
money: 돈
mail: 메일
writing: 쓰기
office: 사무실
lock:  자물쇠
tool: 도구
science: 과학
medical: 의료
household: 세대
other-object: 다른 물건들
transport-sign: 교통 표지
warning: 경고
arrow:  화살표
religion: 종교
zodiac: 조디악
av-symbol: AV 기호
gender: 성별
math: 수학
punctuation: 문장 부호
other-symbol: 다른 기호
keycap: 키캡
alphanum: 영숫자
geometric: 기하학적
flag: 깃발
country-flag: 국가 깃발
subdivision-flag: 세분 플래그
smileys-and-emotion: 스마일 & 감정
people-and-body: 사람과 몸
component: 구성 요소
animals-and-nature: 동물과 자연
food-and-drink: 식음료
travel-and-places: 여행 및 장소
activities: 활동
objects: 사물
symbols: 기호
flags: 깃발