properties: 속성
hide: 숨기다
show: 보여
up: 맨 위로
range: 범위
loading: 로딩 중, 잠시 기다려주십시오
count: 문자의 총 수
sort-order: 순차적으로
sort-block: 문자 범위 세그먼트를 눌러
copy-clipboard: 클립 보드로 복사
help-range: 문자의 범위를 표시하려면 클릭
more: 더
prev: 앞으로
next: 뒤로
separate-page: 새로운 오픈 페이지
share-link: 몫
recent: 충적세
# @todo recent-text
read-more: 자세히보기
read-less: 숨기기

copied: 복사되었습니다!
see_also: 참조
page_content_menu: 내용
homepage: 홈페이지
cookie-message: 이 사이트는 최고의 경험을 보장하기 위해 🍪쿠키를 사용합니다.
accept: 동의하기
empty-cell: 빈 셀
block-description: 설명
more-information: 더 읽기
back: 뒤쪽에
widget-keyboard-title: 심볼 클립보드
widget-keyboard-placeholder: 여기에 복사한 모든 기호가 표시됩니다 ✨

[mobile]
to-full: 정식 버전으로 이동
to-mobile: 모바일 버전

[edit]: 편집
save: 저장
submit: 제출
undo: 취소
send-changes: 변경 사항은 사이트의 개발로 전송됩니다. 당신은 확실한가요?
thanks: 고맙습니다

