title-aside: 카오모지

[kaomoji]: 카오모지
h1: 카오모지

[emotions]: 감정
h1: 감정

joy: 웃는 얼굴
love: 사랑의 얼굴
embarrassment: 수줍은 얼굴
sympathy: 걱정스러운 얼굴
discontent: 화난 얼굴
anger: 화나거나 불만스러운 얼굴
sadness: 슬픈 얼굴
pain: 고통받는 사람
fear: 겁먹은 얼굴
indifference: 회의적인 얼굴
confusion: 당황한 얼굴
doubt: 수상한 사람
surprise: 놀란 얼굴
sleeping: 졸린 얼굴
nosebleed: 고통스러운 얼굴

[animals-and-insects]: 동물과 곤충
h1: 동물과 곤충

cats: 고양이 얼굴
dog: 개 얼굴
bears: 곰 얼굴
rabbits: 토끼 얼굴
pig: 돼지 얼굴
bird: 병아리
fish: 물고기
spider: 거미

[activities-and-activities]: 활동
h1: 활동

greeting: 인사하기
hug: 껴안다
wink: 바람둥이
apologizing: 사과하다
hiding: 숨다
writing: 쓰다
running: 도망치다
music: 노래와 춤
games: 놀다
food: 먹고 마시다
friends: 친구가 되십시오
enemies: 적대감에 빠지다
weapons: 불
magic: 컨저리
table-flipping: 테이블 뒤집기
