title: Символы и смайлики для Instagram
list_title: Символы для Instagram

Popular symbols and icons: Популярные символы и значки
Telephone, e-mail, office: Телефоны, е-мейлы, канцелярия
Arrows: Стрелки
Hearts: Сердечки
Stars, snowflakes: Звёзды, снежинки
Flowers: Цветы
Crosses: Кресты
Arabic and Roman numerals: Арабские и римские цифры
Latin letters in a circle: Латинские буквы в круге
Weather: Погода
Transport symbols: Символы транспорта
Zodiac signs: Знаки зодиака
Suits of playing cards and chess pieces: Масти игральных карт и шахматные фигуры
Currency signs: Знаки валют
Planets: Планеты
Geometric Shapes: Геометрические фигуры
Strange patterns: Странные узоры
Food: Еда
Clothes and shoes: Одежда и обувь
Sport: Спорт
Runes and runic signs: Руны и рунические знаки
Astrological: Астрологические
Musical: Музыкальные
Fingers: Пальцы
Check marks: Галочки
Places: Места
Gender: М/Ж
Recycling: Переработка