title: Simboli per il soprannome
list_title: Simboli per il soprannome

Popular: Popolare

Popular symbols and icons: Icone e simboli popolari
Telephone, e-mail, office: Telefono, e-mail, ufficio
Arrows: Frecce
Hearts: Cuori
Stars, snowflakes: Stelle, fiocchi di neve
Flowers: Fiori
Crosses: Croci
Arabic and Roman numerals: Numeri arabi e romani
Latin letters in a circle: Lettere latine in un cerchio
Weather: Meteo
Transport symbols: Simboli di trasporto
Zodiac signs: Segni zodiacali
Suits of playing cards and chess pieces: Semi di carte da gioco e pezzi degli scacchi
Currency signs: Segni di valuta
Planets: Pianeti
Geometric Shapes: Forme geometriche
Strange patterns: Pattern strani
Food: Cibo
Clothes and shoes: Vestiti e scarpe
Sport: Sport
Runes and runic Signs: rune e segni runici
Astrological: Astrologico
Musical: Musical
Fingers: Dita
Check marks: Segni di spunta
Places: Luoghi
Gender: Genere
Recycling: Riciclaggio

Other: Altro
Letter based characters: Personaggi basati su lettere