title: Ausgefallene Briefe
list_title: Ausgefallene Briefe

square: Quadratische lateinische Gro√übuchstaben
old-english: Englisches Alphabet des alten Stils
runic: Englisches Alphabet im Runenstil

latin: Latein
circle: Eingekreiste lateinische Hauptstadt Briefs
lla: Brief A
llb: Brief B
llc: Brief C
lld: Brief D
lle: Brief E
llf: Brief F
llg: Brief G
llh: Brief H
lli: Brief I
llj: Brief J
llk: Brief K
lll: Brief L
llm: Brief M
lln: Brief N
llo: Brief O
llp: Brief P
llr: Brief R
lls: Brief S
llt: Brief T
llu: Brief U
llv: Brief V
llw: Brief W
llx: Brief X
lly: Brief Y
llz: Brief Z