arab: Alphabet arabe

armenian: Alphabet arménien

avestan: Alphabet avestan

balinese: Alphabet balinaise

bamum: Alphabet bamoun

bashkir: Alphabet bachkir

bassa-vah: Alphabet Bassa-vah

batak: Alphabet batak

belarusian: Alphabet biélorusse

bengali: Alphabet bengali

bopomofo: Alphabet Bopomofo. Zhuyin

brahmi: Alphabet Brahmi

buginese: Alphabet buginais

buhid: Alphabet buhid

bulgarian: Alphabet bulgare

carian: Alphabet cariens

caucasian-albanian: Alphabet albanais caucasien

chakma: Alphabet changma

cham: Alphabet Cham

cherokee: Alphabet cherokee

chinese: Alphabet pinyin chinois

coptic: Alphabet copte

cypriot-syllabary: Syllabaire chypriote

cyrillic: Alphabet cyrillique

czech: Alphabet tchèque

deseret: Alphabet déséret

devanagari: Alphabet devanagari

elbasan: Alphabet elbasan

english: Alphabet anglais

esperanto: Alphabet en espéranto
	
ethiopic: Alphabet geez éthiopique
	
french: Alphabet francais
	
georgian: Alphabet géorgien
	
german: Alphabet allemand
	
glagolitic: Alphabet glagolitique
	
gothic: Alphabet gothique
	
grantha: Alphabet Grantha
	
greek: Alphabet grec
	
gujarati: Alphabet gujarati
	
gurmukhi: Alphabet Gurmukhi
	
hangul: Alphabet Hangul
	
hanunoo: Alphabet Hanunoo
	
hebrew: Alphabet hébreu
	
hungarian: Alphabet hongrois
	
imperial-aramaic: Alphabet araméen impérial
	
international-phonetic-alphabet: Alphabet phonétique international
	
italian: Alphabet Italien
	
japanese-hiragana: Alphabet japonais en hiragana
	
japanese-katakana: Alphabet japonais de katakana
	
javanese: Alphabet javanais
	
kaithi: Alphabet Kaithi
	
kannada: Alphabet Kannada
	
kayah-li: Alphabet Kayah li
	
kazakh: Alphabet Kazakh
	
kharoshthi: Alphabet Kharoshthi
	
khmer: Alphabet Khmer
	
khojki: Alphabet khojki
	
khudawadi: Alphabet Khudawadi
	
lao: Alphabet Lao
	
latin: Alphabet latin
	
lepcha: Alphabet Lepcha
	
limbu: Alphabet Limbu
	
linear-b-Syllabary: Syllabaire linéaire B
	
lisu: Alphabet Lisu
	
lycian: Alphabet Lycien
	
lydian: Alphabet lydien
	
nabataean: Alphabet Nabatéen
	
mahajani: Alphabet Mahajani
	
malayalam: Alphabet malayalam
	
mandaic: Alphabet Mandaic
	
manichaean: Alphabet Manichéen
	
meetei-mayek: Alphabet Meetei Mayek
	
mende-kikakui: Alphabet Mende kikakui
	
meroitic-cursive: Alphabet cursif méroïtique
	
modi: Alphabet Modi
	
mongolian: Alphabet mongol
	
mro: Alphabet Mro
	
myanmar: Alphabet Myanmar
	
new-tai-lue: Alphabet nouvel Tai Lue
	
nko: Alphabet Nko
	
ogham: Alphabet Ngham
	
ol-chiki: Alphabet Ol chiki
	
old-italic: Alphabet ancien étrusque italique
	
old-north-arabian: Alphabet ancien nord-arabe
	
old-permic: Alphabet ancien permic
	
old-persian: Alphabet ancien persan
	
old-south-arabian: Alphabet ancien du sud de l'arabe
	
old-turkic: Alphabet ancien runique turc
	
oriya: Alphabet Oriya
	
osmanya: Alphabet Osmanya
	
pahawh-hmong: Alphabet Pahawh hmong
	
pahlavi: Alphabet Pahlavi
	
palmyrene: Alphabet Palmyrene
	
pau-cin-hau: Alphabet Pau cin hau
	
phags-pa: Alphabet Phags-pa
	
phoenician: Alphabet phénicien
	
polish: Alphabet polonais
	
pollard: Alphabet Pollard
	
rejang: Alphabet Rejang
	
runic: Alphabet runique
	
russian: Alphabet russe
	
samaritan: Alphabet Samaritain
	
saurashtra: Alphabet Saurashtra
	
sharada: Alphabet Sharada
	
shavian: Alphabet Shavian
	
siddham: Alphabet siddham
	
sinhala: Alphabet cinghalais
	
sora-sompeng: Alphabet Sora sompeng
	
spanish: Alphabet espagnol
	
sundanese: Alphabet Sundanese
	
syloti-nagri: Alphabet Syloti Nagri
	
syriac: Alphabet syriaque
	
tagalog: Alphabet Tagalog
	
tagbanwa: Alphabet Tagbanwa
	
tai-le: Alphabet Tai le
	
tai-tham: Alphabet de Tai Tham
	
tai-viet: Alphabet Tai viet
	
takri: Alphabet Takri
	
tamil: Alphabet tamoul
	
tatar: Alphabet tatar
	
telugu: Alphabet Telugu
	
thaana: Alphabet Thaana
	
thai: Alphabet thaï
	
tibetan: Alphabet tibétain
	
tifinagh: Alphabet Tifinagh
	
tirhuta: Alphabet Tirhuta
	
turkish: Alphabet turc
	
ugaritic: Alphabet ougaritique
	
ukrainian: Alphabet ukrainien
	
unified-canadian-aboriginal-syllabics: Syllabaire unifié canadien aborigène
	
vai: Syllabaire Vai
	
varang-kshiti: Alphabet Varang kshiti
	
yi-syllables: Syllabaire Yi
