bastille-day: Fête nationale française
winter-olympic-games: Jeux olympiques d'hiver
summer-olympic-games: Jeux olympiques d'été 2020
fifa-world-cup: Coupe du monde de football
new-year: Jour de l'an
valentine-day: Saint-Valentin
8-march: Journée internationale des femmes
saint-patricks-day: Fête de la Saint-Patrick
april-fools-day: Poisson d'avril
1-may: Journée internationale des travailleurs
victory-day: Jour de la Victoire (9 mai)
eid-al-fitr: Aïd el-Fitr
uefa-champions-league: Ligue des champions de l'UEFA
international-childrens-day: Journée de l'enfance
international-chess-day: Journée internationale des échecs
birthday-of-the-smiley: Anniversaire du smiley
halloween: Halloween
hanukkah: Hanoucca
christmas: Noël
oktoberfest: Oktoberfest
easter-catolic: Pâques
uefa-european-championship: Championnat d'Europe de football

new-year-date: Aujourd'hui, 1er janvier
winter-olympic-games-date: Aujourd'hui, 4 février
valentine-day-date: Aujourd'hui, 14 février
8-march-date: Aujourd'hui, 8 mars
saint-patricks-day-date: Aujourd'hui, 17 mars
april-fools-day-date: Aujourd'hui, le 1er avril
easter-catolic-date: Aujourd'hui, 17 avril
1-may-date: Aujourd'hui, 1er mai
eid-al-fitr-date: Aujourd'hui c'est le 21 avril
victory-day-date: Aujourd'hui, 9 mai
uefa-champions-league-date: Aujourd'hui, 28 mai
international-childrens-day-date: Aujourd'hui, le 1er juin
international-chess-day-date: Aujourd'hui, 20 juillet
birthday-of-the-smiley-date: Aujourd'hui, 19 septembre
oktoberfest-date: Aujourd'hui, 19 septembre
halloween-date: Aujourd'hui, 31 octobre
fifa-world-cup-date: Aujourd'hui, 21 novembre
hanukkah-date: Aujourd'hui, 18 décembre
christmas-date: Aujourd'hui, 25 décembre

bastille-day-date: Aujourd'hui, 14 juillet
