winter-olympic-games: Зимняя олимпиада
summer-olympic-games: Летняя олимпиада 2020
fifa-world-cup: Чемпионат мира по футболу
christmas: Католическое Рождество
new-year-ru: Новый год
valentine-day: День святого Валентина
23-february: День защитника Отечества
maslenica: Масленица
8-march: 8 марта Международный женский день
saint-patricks-day: День святого Патрика
april-fools-day: 1-ое апреля День дураков
cosmonautics-day: День космонавтики
easter-orthodox: Пасха
1-may: 1-ое мая Праздник Весны и Труда
victory-day: День Победы
eid-al-fitr: Ураза-байрам
uefa-champions-league: Лига чемпионов УЕФА
international-childrens-day: Международный день защиты детей
graduation: Выпускной вечер
international-chess-day: Международный день шахмат
navy-day: День Военно-Морского Флота
den-vdv: День Воздушно-десантных войск
knowledge-day: 1-ое сентября День знаний
birthday-of-the-smiley: День рождения смайлика
oktoberfest: Октоберфест
halloween: Хеллоуин
hanukkah: Ханука
uefa-european-championship: Чемпионат Европы по футболу
day-of-the-dead: День Мёртвых

new-year-ru-date: Сегодня, 1 января
winter-olympic-games-date: Сегодня, 2 февраля
valentine-day-date: Сегодня, 14 февраля
23-february-date: Сегодня, 23 февраля
maslenica-date: Сегодня, 28 февраля
8-march-date: Сегодня, 8 марта
saint-patricks-day-date: Сегодня, 17 марта
april-fools-day-date: Сегодня, 1 апреля
cosmonautics-day-date: Сегодня, 12 апреля
easter-orthodox-date: Сегодня, 16 апреля
1-may-date: Сегодня, 1 мая
eid-al-fitr-date: Сегодня, 21 апреля
victory-day-date: Сегодня, 9 мая
uefa-champions-league-date: Сегодня, 28 мая
international-childrens-day-date: Сегодня, 1 июня
graduation-date: Сегодня, 24 июня
international-chess-day-date: Сегодня, 20 июля
navy-day-date: Сегодня, 25 июля
den-vdv-date: Сегодня, 2 августа
knowledge-day-date: Сегодня, 1 сентября
birthday-of-the-smiley-date: Сегодня, 19 сентября
oktoberfest-date: Сегодня, 19 сентября
halloween-date: Сегодня, 31 октября
fifa-world-cup-date: Сегодня, 21 ноября
hanukkah-date: Сегодня, 18 декабря
christmas-date: Сегодня, 25 декабря
