title: फैंसी पत्र
list_title: फैंसी पत्र

square: चुकता लैटिन राजधानी पत्र
old-english: पुरानी शैली अंग्रेजी वर्णमाला
runic: रूनिक शैली अंग्रेजी वर्णमाला

latin: लैटिन
circle: लैटिन राजधानी के अक्षरों का चक्कर लगाया
lla: पत्र A
llb: पत्र B
llc: पत्र C
lld: पत्र D
lle: पत्र E
llf: पत्र F
llg: पत्र G
llh: पत्र H
lli: पत्र I
llj: पत्र J
llk: पत्र K
lll: पत्र L
llm: पत्र M
lln: पत्र N
llo: पत्र O
llp: पत्र P
llq: पत्र Q
llr: पत्र R
lls: पत्र S
llt: पत्र T
llu: पत्र U
llv: पत्र V
llw: पत्र W
llx: पत्र X
lly: पत्र Y
llz: पत्र Z