smileys-people: स्माइलीज एंड पीपल
animals-nature: पशु और प्रकृति
food-drink: खाद्य पेय
activity: गतिविधि
travel-places: यात्रा और स्थान
objects: वस्तुओं
symbols: प्रतीक
flags: झंडे
unsorted: अवर्गीकृत
currency: मुद्रा
smileys-and-emotion: स्माइलीज और इमोशन
face-smiling: मुस्कराता चेहरा
face-affection: कामुक चेहरा (स्नेह)
face-tongue: जीभ से चेहरा
face-hand: हाथ से चेहरा
face-neutral-skeptical: उदासीन और शंकित चेहरा
face-sleepy: सोया हुआ लग रहा चेहरा
face-unwell: बीमार चेहरा
face-hat: टोपी के साथ चेहरा
face-glasses: चश्मे से चेहरा
face-concerned: चिंतित चेहरा
face-negative: गुस्सैल चेहरा
face-costume: फैंसी पोशाक
cat-face: मुह बनाना
monkey-face: बंदर चेहरा
emotion: भावना
people-and-body: लोग और शरीर
hand-fingers-open: उंगलियों से खुला हाथ
hand-fingers-partial: उंगलियों से आंशिक हाथ
hand-single-finger: एक उंगली से हाथ
hand-fingers-closed: अंगुलियों से बंद हाथ
hands: हाथ
hand-prop: हाथ के गुण
body-parts: शरीर के अंग
person: व्यक्ति
person-gesture: व्यक्ति का इशारा
person-role: व्यक्ति की भूमिका
person-fantasy: काल्पनिक और परी कथा व्यक्ति
person-activity: व्यक्ति की गतिविधि
person-sport: खेल कर रहे व्यक्ति
person-resting: आराम करने वाला व्यक्ति
family: परिवार
person-symbol: व्यक्ति का प्रतीक
component: अंग
skin-tone: त्वचा का रंग
hair-style: बाल शैली
animals-and-nature: पशु और प्रकृति
animal-mammal: सस्तन प्राणी
animal-bird: चिड़िया
animal-amphibian: उभयचर
animal-reptile: साँप
animal-marine: समुद्री जानवर
animal-bug: बग
plant-flower: फूल
plant-other: अन्य पौधे
food-and-drink: खाद्य पेय
food-fruit: फल
food-vegetable: सबजी
food-prepared: बनाया हुआ खाना
food-asian: एशियाई भोजन
food-marine: समुद्री भोजन
food-sweet: मीठा भोजन
drink: पीना
dishware: डिशवेयर
travel-and-places: यात्रा और स्थान
place-map: नक्शा
place-geographic: भौगोलिक स्थान
place-building: इमारत
place-religious: धार्मिक स्थल
place-other: अन्य स्थान
transport-ground: जमीन परिवहन
transport-water: जल परिवहन
transport-air: वायु परिवहन
hotel: होटल
time: समय
sky-and-weather: आकाश और मौसम
activities: क्रियाएँ
event: प्रतिस्पर्धा
award-medal: पदक और पुरस्कार
sport: खेल
game: खेल
arts-and-crafts: कला एवं शिल्प
clothing: कपड़े
sound: ध्वनि
music: संगीत
musical-instrument: संगीत के उपकरण
phone: फ़ोन
computer: संगणक
light-and-video: प्रकाश और वीडियो
book-paper: कागज की किताब
money: पैसे
mail: मेल
writing: लिख रहे हैं
office: कार्यालय
lock: ताला
tool: साधन
science: विज्ञान
medical: मेडिकल
household: गृहस्थी
other-object: अन्य वस्तुएं
transport-sign: परिवहन संकेत
warning: चेतावनी
arrow: तीर
religion: धर्म
zodiac: राशि
av-symbol: एवी प्रतीक
gender: लिंग
math: गणित
punctuation: विराम चिह्न
other-symbol: अन्य प्रतीक
keycap: keycap
alphanum: अक्षरांकीय
geometric: ज्यामितिक
flag: झंडा
country-flag: देश का झंडा
subdivision-flag: उपखंड ध्वज
smileys-and-emotion: स्माइलीज और इमोशन
people-and-body: लोग और शरीर
component: अंग
animals-and-nature: पशु और प्रकृति
food-and-drink: खाद्य पेय
travel-and-places: यात्रा और स्थान
activities: क्रियाएँ
objects: वस्तुओं
symbols: प्रतीक
flags: झंडे