hide: рдЫрд┐рдкрд╛рдиреЗ
show: рдкреНрд░рджрд░реНрд╢рди
up	: рдКрдкрд░
range	: рд░реЗрдВрдЬ
loading	: рд▓реЛрдб рд╣реЛ рд░рд╣рд╛ рд╣реИ, рдХреГрдкрдпрд╛ рдкреНрд░рддреАрдХреНрд╖рд╛ рдХрд░реЗрдВ...
count	: рд╡рд░реНрдгреЛрдВ рдХреА рд╕рдВрдЦреНрдпрд╛
sort-order	: рд╣реБрдХреНрдо рд╕реЗ
sort-block	: рдмреНрд▓реЙрдХ
copy-clipboard	: рдХреНрд▓рд┐рдкрдмреЛрд░реНрдб рдкрд░ рдХреЙрдкреА рдХрд░реЗрдВ
help-range	: рд╕реАрдорд╛ рдкрд░ рдкреНрд░рдХрд╛рд╢ рдбрд╛рд▓рд╛ рдХреЗ рд▓рд┐рдП рдХреНрд▓рд┐рдХ рдХрд░реЗрдВ
more	: рдЕрдзрд┐рдХ
prev	: рдкрд┐рдЫрд▓рд╛
next	: рдЖрдЧрд╛рдореА
separate-page	: рдЕрд▓рдЧ рдкреЗрдЬ рдореЗрдВ рдЦреЛрд▓реЗрдВ
share-link	: рджреЛрд╕реНрддреЛрдВ рдХреЗ рд╕рд╛рде рдмрд╛рдВрдЯреЗрдВ
recent	: рд╣рд╛рд▓ рдХрд╛
recent-text	: рдпрд╣рд╛рдВ рд╣рд╛рд▓ рд╣реА рдореЗрдВ рдкреНрд░рдпреБрдХреНрдд рдкреНрд░рддреАрдХреЛрдВ рдХреЛ рдкреНрд░рджрд░реНрд╢рд┐рдд рдХрд░реЗрдЧрд╛ред рдЕрдм рддрдХ, рд▓реЛрдХрдкреНрд░рд┐рдп рдкреНрд░рддреАрдХреЛрдВ рдХреЛ рджреЗрдЦрдиреЗ
read-more	: рдЕрдзрд┐рдХ рдкрдврд╝реЗрдВ
read-less	: рдЫрд┐рдкрд╛рдирд╛
madeby	: рджреНрд╡рд╛рд░рд╛ рдирд┐рд░реНрдорд┐рдд
keepupdates	: рд╣рдорд╛рд░рд╛ рдЕрдиреБрд╕рд░рдг рдХрд░реЛ
hint	: рдХрд╛ рдЪрдпрди рдХрд░реЗрдВ рдФрд░ рдЪрд░рд┐рддреНрд░ рдХреА рдирдХрд▓ рдЖрдк рдХреА рдЬрд░реВрд░рдд рд╣реИ

copied: рдХреЙрдкреА рдХрд┐рдпрд╛ рдЧрдпрд╛!
see_also: рдЗрдиреНрд╣реЗрдВ рднреА рджреЗрдЦреЗрдВ
page_content_menu: рд╕рд╛рдордЧреНрд░реА рдХреА рддрд╛рд▓рд┐рдХрд╛
homepage: рдореБрдЦрдкреГрд╖реНрда
cookie-message: рдЗрд╕ рд╕рд╛рдЗрдЯ рдореЗрдВ рдЙрдкрдпреЛрдЧ рдХрд░рддрд╛ рд╣реИ ЁЯНкрдХреБрдХреАрдЬрд╝ рд╣реИ рдХрд┐ рдЖрдк рд╕рдмрд╕реЗ рдЕрдЪреНрдЫрд╛ рдЕрдиреБрднрд╡ рдкреНрд░рд╛рдкреНрдд рд╕реБрдирд┐рд╢реНрдЪрд┐рдд рдХрд░рдиреЗ рдХреЗ рд▓рд┐рдПред
accept: рд╕реНрд╡реАрдХрд╛рд░ рдХрд░рдирд╛
empty-cell: рдЦрд╛рд▓реА рд╕реЗрд▓

[mobile]	
to-full	: рдкреВрд░реНрдг рд╕рдВрд╕реНрдХрд░рдг рдХреЗ рд▓рд┐рдП рдЬрд╛рдирд╛
to-mobile	: рдореЛрдмрд╛рдЗрд▓ рд╡рд░реНрд╢рди
	
[edit]	: рд╕рдВрдкрд╛рджрд┐рдд рдХрд░реЗрдВ
save	: рдмрдЪрд╛рдирд╛
submit	: рдЬрдорд╛ рдХрд░реЗрдВ
undo	: рдкреВрд░реНрд╡рд╡рдд рдХрд░реЗрдВ
send-changes	: рдЖрдкрдХреЗ рдкрд░рд┐рд╡рд░реНрддрди рд╡реЗрдмрд╕рд╛рдЗрдЯ рдбреЗрд╡рд▓рдкрд░реНрд╕ рдХреЗ рд▓рд┐рдП рднреЗрдЬ рджрд┐рдпрд╛ рдЬрд╛рдПрдЧрд╛ред рдХреНрдпрд╛ рдЖрдкрдХреЛ рдпрдХреАрди рд╣реИ?
thanks	: рдзрдиреНрдпрд╡рд╛рдж!

