smileys-people: Смайлики и люди
animals-nature: Природа и животные
food-drink: Еда и напитки
activity: Деятельность и активность
travel-places: Места и путешествия
objects: Объекты
symbols: Символы
flags: Флаги
unsorted: Неклассифицированные смайлики
currency: Валюта
smileys-and-emotion: Смайлики и эмоции
face-smiling: Улыбающиеся лица
face-affection: Влюбленные лица
face-tongue: Лица с языком
face-hand: Лица с рукой
face-neutral-skeptical: Нейтральные или скептические лица
face-sleepy: Сонные лица
face-unwell: Болезненные лица
face-hat: Лица со шляпой
face-glasses: Лица с очками
face-concerned: Обеспокоенные лица
face-negative: Злые или недовольные лица
face-costume: Карнавальные маски и костюмы
cat-face: Кошачьи мордочки
monkey-face: Мордочка обезьяны
emotion: Эмоции
people-and-body: Люди и тело
hand-fingers-open: Открытая ладонь с пальцами
hand-fingers-partial: Рука с пальцами
hand-single-finger: Рука с одним пальцем
hand-fingers-closed: Закрытая ладонь с пальцами
hands: Руки
hand-prop: Руки и аксессуары
body-parts: Части тела
person: Человек
person-gesture: Жесты
person-role: Роли и образы
person-fantasy: Сказочные и вымышленные персонажи
person-activity: Человек, выполняющий дествие
person-sport: Спорт
person-resting: Отдых
family: Семья
person-symbol: Нейтральные символы людей
component: Составная часть Эмоджи
skin-tone: Цвет кожи
hair-style: Прически
animals-and-nature: Природа и животные
animal-mammal: Млекопитающие
animal-bird: Птицы
animal-amphibian: Земноводные
animal-reptile: Рептилии
animal-marine: Морские животные
animal-bug: Насекомые
plant-flower: Цветы
plant-other: Другие растения
food-and-drink: Еда и напитки
food-fruit: Фрукты
food-vegetable: Овощи
food-prepared: Приготовленная еда
food-asian: Восточная кухня
food-marine: Морепродукты
food-sweet: Сладости
drink: Напитки
dishware: Посуда
travel-and-places: Места и путешествия
place-map: Карта и глобус
place-geographic: Места
place-building: Здания и строения
place-religious: Религиозные места
place-other: Другие места
transport-ground: Наземный транспорт
transport-water: Водный транспорт
transport-air: Воздушный транспорт
hotel: Отели и гостиницы
time: Время
sky-and-weather: Небо и погода
activities: Действия и занятия
event: События
award-medal: Награды
sport: Спорт
game: Игры
arts-and-crafts: Искусство и хобби
clothing: Одежда
sound: Звук
music: Музыка
musical-instrument: Музыкальные инструменты
phone: Телефон
computer: Компьютер
light-and-video: Осветительные приборы, фото- и видеоаппаратура
book-paper: Бумажные книги
money: Деньги
mail: Почта
writing: Письменные принадлежности
office: Офис
lock: Замки и ключи
tool: Инструменты
science: Наука
medical: Медицина
household: Домашняя утварь
other-object: Прочие предметы
transport-sign: Транспортные информационные знаки
warning: Предупреждающие знаки
arrow: Стрелки
religion: Религия
zodiac: Знаки зодиака
av-symbol: Символы видеопроигрователя
gender: Гендер
math: Математика
punctuation: Пунктуация
other-symbol: Другие символы
keycap: Цифры и кнопки телефона
alphanum: Буквенно-цифровые обозначения
geometric: Геометрические фигуры
flag: Флаги
country-flag: Флаги стран
subdivision-flag: Флаги регионов и областей
smileys-and-emotion: Смайлики и эмоции
people-and-body: Люди и тело
component: Составная часть Эмоджи
animals-and-nature: Природа и животные
food-and-drink: Еда и напитки
travel-and-places: Места и путешествия
activities: Действия и занятия
objects: Объекты
symbols: Символы
flags: Флаги