title-aside: Каомодзи

[kaomoji]: Каомодзи
h1: Каомодзи

[emotions]: Эмоции
h1: Каомодзи эмоций

joy: Улыбающиеся лица
love: Влюбленные лица
embarrassment: Застенчивые лица
sympathy: Обеспокоенные лица
discontent: Раздраженные лица
anger: Злые или недовольные лица
sadness: Грустные лица
pain: Страдающие лица
fear: Испуганные лица
indifference: Скептические лица
confusion: Недоумевающие лица
doubt: Подозрительные лица
surprise: Удивленные лица
sleeping: Сонные лица
nosebleed: Болезненные лица

[animals-and-insects]: Животные и насекомые
h1: Каомодзи животных и&nbsp;насекомых

cats: Кошачьи мордочки
dog: Собачьи мордочки
bears: Медвежьи мордочки
rabbits: Кроличьи мордочки
pig: Свиные мордочки
bird: Птенец
fish: Рыба
spider: Паук

[activities-and-activities]: Действия и занятия
h1: Каомодзи действий и&nbsp;занятий

greeting: Приветствовать
hug: Обнимать
wink: Кокетничать
apologizing: Просить прощения
hiding: Прятаться
writing: Писать
running: Бежать
music: Петь и танцевать
games: Играть
food: Есть и пить
friends: Дружить
enemies: Враждовать
weapons: Стрелять
magic: Колдовать
table-flipping: Бросать стол
