properties: Tulajdons√°gok
hide: Elrejt√©se
show: Mutat
up: Fel
range: Hat√≥t√°vols√°g
loading: Bet√∂lt√©s, k√©rlek, v√°rj...
count: Karakterek sz√°ma
sort-order: Rend szerint
sort-block: Blokk szerint
copy-clipboard: M√°sol√°s a v√°g√≥lapra
help-range: Kattint√°ssal kijel√∂lheti a tartom√°nyt
more: T√∂bb
prev: El≈ëz≈ë
next: K√∂vetkez≈ë
separate-page: Nyissa meg k√ºl√∂n oldalon
share-link: Oszd meg a bar√°taiddal
recent: Friss
recent-text: Itt megjelenik a k√∂zelm√∫ltban haszn√°lt szimb√≥lumok. Eddig, n√©zze meg a n√©pszer≈± szimb√≥lumokat
read-more: Olvass tov√°bb
read-less: Elrejt
madeby: K√©sz√≠tette
keepupdates: K√∂vess minket
hint: Jel√∂lje ki √©s m√°solja a k√≠v√°nt karaktert

copied: M√°solva!
see_also: L√°sd m√©g
page_content_menu: Tartalomjegyz√©k
homepage: Kezd≈ëlap
cookie-message: Ez az oldal üç™s√ºtiket haszn√°l a legjobb √©lm√©ny biztos√≠t√°sa √©rdek√©ben.
accept: Elfogad
empty-cell: √úres cella
block-description: Le√≠r√°s
more-information: Olvass tov√°bb
back: Vissza
widget-keyboard-title: Karakterek √©s nyilak billenty≈±zete
widget-keyboard-placeholder: Itt jelennek meg az √∂sszes szimb√≥lum, amelyet m√°solsz ‚ú®

[mobile]
to-full: Teljes verzi√≥
to-mobile: Mobil verzi√≥

[edit]: Szerkeszt√©s
save: Ment√©s
submit: Elk√ºld√©s
undo: Visszavon√°s
send-changes: A m√≥dos√≠t√°sokat elk√ºldj√ºk a webhely fejleszt≈ëinek. Biztos vagy ebben?
thanks: K√∂sz√∂nj√ºk!
