emotion: Érzelem

joy: Mosolygó arc
love: Egy szerelmes arc
embarrassment: Félénk arc
sympathy: Érintett arc
discontent: Irritált arc
аnger: Gonosz vagy bosszús arc
sadness: Szomorú arc
pain: Szenvedő arc
fear: Rémült arc
indifference: Szkeptikus arc
confusion: Megdöbbentett arc
doubt: Gyanús arc
surprise: Meglepett arc
sleeping: Álmos arc
nosebleed: Fájdalmas arc


animals: Állatok és rovarok

cats: Macska arcok
dog: Kutya arcok
bears: Medve arcok
rabbits: Nyúl arcok
pig: Sertés arcok
bird: Fióka
fish: Hal
spider: Pók


actions: Tevékenységek

greeting: Üdvözöl
hug: Ölelés
wink: Flört
apologizing: Bocsánatot kér
hiding: Elrejt
writing: Írás
running: Fuss
music: Ének és tánc
games: Játék
food: Enni és inni
friends: Barátoknak lenni
enemies: Legyen ellenségek
weapons: Lő
magic: Varázslat






