properties: Eigenschaften
hide: Wegpacken
show: Aufweisen
up: Hinauf
range: Bereich
loading: Laden, bitte warten‚Ä¶
count: Anzahl der Zeichen
sort-order: Der Reihe nach
sort-block: Abschnittsweise
copy-clipboard: In die Zwischenablage kopieren
help-range: Dr√ºcken, um anzuleuchten
more: Mehr
prev: Vorher.
next: Folgend.
separate-page: √ñffnen einer separaten Seite
share-link: Teilen
# @todo recent
# @todo recent-text
read-more: Weiterlesen
read-less: Verbergen
homepage: Startseite
block-description:	Beschreibung
more-information: Weiterlesen
back: Zur√ºck
widget-keyboard-title: Symboltastatur
widget-keyboard-placeholder: Hier werden alle Symbole angezeigt, die Sie kopieren ‚ú®

copied: Kopiert!
see_also: Siehe auch
cookie-message: Diese Seite verwendet üç™cookie, um Ihnen die bestm√∂gliche Erfahrung zu bieten.
accept: Akzeptieren
empty-cell: Leere Zelle
page_content_menu: Ordnerverzeichnis
[mobile]
to-full: Zur Vollversion
# @todo to-mobile

[edit]: Bearbeiten
save: Speichern
submit: Einreichen
undo: R√ºckg√§ngig
send-changes: Bitte best√§tigen Sie die vorgenommenen √Ñnderungen. Sie werden zur √úberpr√ºfung an die Redaktion √ºbermittelt.
thanks: Danke!
