emotion: Emotion

joy: Lächelndes Gesicht
love: Verliebter Gesicht
embarrassment: Schüchternes Gesicht
sympathy: Betroffenes Gesicht
discontent: Gereiztes Gesicht
аnger: Böses oder verärgertes Gesicht
sadness: Trauriges Gesicht
pain: Gesichtsgesicht
fear: Verängstigtes Gesicht
indifference: Skeptisches Gesicht
confusion: Verblüfftes Gesicht
doubt: Verdächtiges Gesicht
surprise: Überraschtes Gesicht
sleeping: Verschlafenes Gesicht
nosebleed: Schmerzhaftes Gesicht


animals: Tiere und Insekten

cats: Katzengesicht
dog: Hundegesicht
bears: Bärengesicht
rabbits: Kaninchengesicht
pig: Schweinegesicht
bird: Küken
fish: Fisch
spider: Spinne


actions: Aktivitäten

greeting: Grüßen
hug: Umarmung
wink: Flirt
apologizing: Sich entschuldigen
hiding: Sich verstecken
writing: Schreiben
running: Lauf
music: Singen und tanzen
games: Spiel
food: Essen und Trinken
friends: Freunde sein
enemies: Mit Feindschaft sein
weapons: Schießen
magic: Zaubern