arab: Alfabeto árabe 

armenian: Alfabeto armenio 

avestan: Alfabeto avestano

balinese: Alfabeto balinés

bamum: Alfabeto bamum

bashkir: Alfabeto baskir

bassa-vah: Alfabeto bassa-vah

batak: Alfabeto batak

belarusian: Alfabeto bielorruso

bengali: Alfabeto bengalí

bopomofo: Alfabeto Bopomofo. Zhuyin

brahmi: Alfabeto Brahmi

buginese: Alfabeto bugino

buhid: Buhid Alfabeto

bulgarian: Alfabeto búlgaro

carian: Alfabeto cario

caucasian-albanian: Alfabeto albanés caucásico

chakma: Alfabeto chakma

cham: Alfabeto cham

cherokee: Alfabeto cherokee

chinese: Alfabeto Chino pinyin 

coptic: Alfabeto copto

cypriot-syllabary: Silabario chipriota

cyrillic: Alfabeto cirílico

czech: Alfabeto checo

deseret: Alfabeto Deseret

devanagari: Alfabeto devanagari

elbasan: Alfabeto elbasan

english: Alfabeto inglés

esperanto: Alfabeto del esperanto
	
ethiopic: Alfabeto Geʻez etíope
	
french: Alfabeto francés
	
georgian: Alfabeto georgiano
	
german: Alfabeto aleman
	
glagolitic: Alfabeto glagolitico
	
gothic: Alfabeto gótico
	
grantha: Alfabeto Grantha
	
greek: Alfabeto griego
	
gujarati: Alfabeto gujarati
	
gurmukhi: Alfabeto de Gurmukhi
	
hangul: Alfabeto de hangul
	
hanunoo: Alfabeto Hanunoo
	
hebrew: Alfabeto hebreo
	
hungarian: Alfabeto húngaro
	
imperial-aramaic: Alfabeto arameo imperial
	
international-phonetic-alphabet: Alfabeto Fonético Internacional
	
italian: Alfabeto italiano
	
japanese-hiragana: Alfabeto hiragana japonés
	
japanese-katakana: Alfabeto japonés katakana
	
javanese: Alfabeto javanés
	
kaithi: Alfabeto Kaithi
	
kannada: Alfabeto kannada
	
kayah-li: Alfabeto Kayah li 
	
kazakh: Alfabeto kazajo
	
kharoshthi: Alfabeto Kharoshthi
	
khmer: Alfabeto Khmer
	
khojki: Alfabeto Khojki
	
khudawadi: Alfabeto Khudawadi
	
lao: Alfabeto lao
	
latin: Alfabeto latino
	
lepcha: Alfabeto Lepcha
	
limbu: Alfabeto de Limbu
	
linear-b-Syllabary: Silabario lineal B
	
lisu: Alfabeto de lisu
	
lycian: Alfabeto liciano
	
lydian: Alfabeto de lidia
	
nabataean: Alfabeto nabateo
	
mahajani: Alfabeto Mahajani
	
malayalam: Alfabeto malayalam
	
mandaic: Alfabeto mandaico
	
manichaean: Alfabeto maniquea
	
meetei-mayek: Alfabeto Meetei mayek 
	
mende-kikakui: Alfabeto kikakui mende
	
meroitic-cursive: Alfabeto cursivo meroitico
	
modi: Alfabeto Modi
	
mongolian: Alfabeto mongol
	
mro: Alfabeto de mro
	
myanmar: Alfabeto de myanmar
	
new-tai-lue: Alfabeto nuevo de tai lue
	
nko: Alfabeto de nko
	
ogham: Alfabeto de Ngham
	
ol-chiki: Alfabeto Ol Chiki
	
old-italic: Alfabeto antiguo cursiva etrusca
	
old-north-arabian: antiguo alfabeto del norte de arabe
	
old-permic: Alfabeto antiguo permico
	
old-persian: Alfabeto antiguo persa
	
old-south-arabian: Alfabeto antiguo árabe del sur
	
old-turkic: Alfabeto antiguo turco rúnico
	
oriya: Alfabeto de oriya
	
osmanya: Alfabeto de osmanya
	
pahawh-hmong: Alfabeto pahawh hmong 
	
pahlavi: Alfabeto Pahlavi
	
palmyrene: Alfabeto de palmyrene
	
pau-cin-hau: Alfabeto Pau cin hau
	
phags-pa: Alfabeto phags-pa
	
phoenician: Alfabeto fenicio
	
polish: Alfabeto polaco
	
pollard: Alfabeto Pollard
	
rejang: Alfabeto de Rejang
	
runic: Alfabeto rúnico
	
russian: Alfabeto ruso
	
samaritan: Alfabeto samaritano
	
saurashtra: Alfabeto Saurashtra
	
sharada: Alfabeto de Sharada
	
shavian: Alfabeto Shavian
	
siddham: Alfabeto de Siddham
	
sinhala: Alfabeto sinhala
	
sora-sompeng: Alfabeto Sora sompeng 
	
spanish: Alfabeto español
	
sundanese: Alfabeto sundanés
	
syloti-nagri: Alfabeto Syloti nagri 
	
syriac: Alfabeto siríaco
	
tagalog: Alfabeto tagalo
	
tagbanwa: Alfabeto Tagbanwa
	
tai-le: Alfabeto de tai le
	
tai-tham: Alfabeto de tai tham
	
tai-viet: Alfabeto vietnam
	
takri: Alfabeto de Takri
	
tamil: Alfabeto tamil
	
tatar: Alfabeto tártaro
	
telugu: Alfabeto telugu
	
thaana: Alfabeto de thaana
	
thai: Alfabeto tailandés
	
tibetan: Alfabeto tibetano
	
tifinagh: Alfabeto Tifinagh
	
tirhuta: Alfabeto Tirhuta
	
turkish: Alfabeto turco
	
ugaritic: Alfabeto ugaritico
	
ukrainian: Alfabeto ucraniano
	
unified-canadian-aboriginal-syllabics: Silabario aborigen canadiense unificado
	
vai: Silabario Vai
	
varang-kshiti: Alfabeto Varang Kshiti
	
yi-syllables: Silabario Yi
