new-year: Año Nuevo
new-year-ru: Año nuevo en Rusia
fifa-world-cup: FIFA Copa del Mundo
chinese-new-year: Año Nuevo Chino
valentine-day: Día de San Valentín
23-february: Defensor del Día de la Patria en Rusia
maslenica: Shrovetide - Las vacaciones eslavas del comienzo de la primavera
8-march: Día Internacional de la Mujer
saint-patricks-day: Día de San Patricio
holi: Holi - Festival de colores en India
april-fools-day: Día de los Inocentes
cosmonautics-day: Día de la cosmonautia
easter-catolic: Católica de Pascua
easter-orthodox: Pascua ortodoxa
1-may: Fiesta de la primavera y el trabajo en Rusia
cinco-de-mayo: Chinko de Mayo
victory-day: Día de la victoria en Rusia
uefa-champions-league: UEFA de la Liga de Campeones
international-childrens-day: Día internacional del niño
eid-al-fitr: Kurban Bayram
dragon-boat-festival: Festival del Bote del Dragón
queens-official-birthday: Cumpleaños oficial de la reina en el Reino Unido
graduation: Graduación de bachillerato
independence-day: Día de la Independencia en los Estados Unidos
uefa-european-championship: Campeonato de Europa de la UEFA
international-chess-day: Día internacional de ajedrez
bastille-day: Día de la Bastilla
navy-day: Día de la Marina en Rusia
den-vdv: Día de las Fuerzas Aerotransportadas en Rusia
knowledge-day: Día del Conocimiento en Rusia
birthday-of-the-smiley: Cumpleaños de Smiley
oktoberfest: Festival de octubre
diwali: Dili
halloween: Víspera de Todos los Santos
day-of-the-dead: El día de los Muertos
guy-fawkes-night: Guy Fox Night
thanksgiving: Día de Acción de Gracias en EE. UU.
black-friday: Viernes Negro
hanukkah: Hanukkah
christmas: Navidad
summer-olympic-games: Juegos Olímpicos de verano
winter-olympic-games: Juegos olímpicos de invierno


new-year-date: Hoy, 1 de enero
winter-olympic-games-date: Hoy, 4 de febrero
valentine-day-date: Hoy, 14 de febrero
8-march-date: Hoy, 8 de marzo
saint-patricks-day-date: Hoy, 17 de marzo
april-fools-day-date: Hoy, 1 de abril
easter-catolic-date: Hoy, 17 de abril
1-may-date: Hoy, 1 de mayo
cinco-de-mayo-date: Hoy, 5 de mayo
eid-al-fitr-date: Hoy, 21 de abril
victory-day-date: Hoy, 9 de mayo
uefa-champions-league-date: Hoy, 28 de mayo
international-childrens-day-date: Hoy, 1 de junio
international-chess-day-date: Hoy, 20 de julio
birthday-of-the-smiley-date: Hoy, 19 de septiembre
oktoberfest-date: Hoy, 19 de septiembre
halloween-date: Hoy, 31 de octubre
fifa-world-cup-date: Hoy, 21 de noviembre
hanukkah-date: Hoy, 18 de diciembre
christmas-date: Hoy, 25 de diciembre
day-of-the-dead-date: Hoy, 1 de noviembre
