smileys-people: Faccine e persone
animals-nature: Animali e natura
food-drink: Cibo bevanda
activity: Attività
travel-places: Viaggi e luoghi
objects: Oggetti
symbols: Simboli
flags: Bandiere
unsorted: Nessuna classe
currency: Moneta
smileys-and-emotion: Faccine ed emozione
face-smiling: Faccia sorridente
face-affection: Faccia amorosa (affetto)
face-tongue: Faccia con la lingua
face-hand: Faccia con la mano
face-neutral-skeptical: Faccia neutra e scettica
face-sleepy: Faccia assonnata
face-unwell: Faccia malata
face-hat: Faccia con cappello
face-glasses: Faccia con gli occhiali
face-concerned: Volto preoccupato
face-negative: Faccia arrabbiata
face-costume: Costume di fantasia
cat-face: Faccia di gatto
monkey-face: Faccia di scimmia
emotion: Emozione
people-and-body: Persone e corpo
hand-fingers-open: Mano aperta con le dita
hand-fingers-partial: Mano parziale con le dita
hand-single-finger: Mano con un solo dito
hand-fingers-closed: Mano chiusa con le dita
hands: Mani
hand-prop: Proprietà della mano
body-parts: Parti del corpo
person: Persona
person-gesture: Gesti
person-role: Ruolo
person-fantasy: Persona di fantasia e fiaba
person-activity: Attività della persona
person-sport: Persona che fa sport
person-resting: Persona a riposo
family: Famiglia
person-symbol: Simbolo della persona
component: Componente
skin-tone: Il tono della pelle
hair-style: Stile di capelli
animals-and-nature: Animali e natura
animal-mammal: Mammifero
animal-bird: Uccello
animal-amphibian: Anfibio
animal-reptile: Rettile
animal-marine: Animale marino
animal-bug: Insetto
plant-flower: Fiore
plant-other: Altre piante
food-and-drink: Cibo bevanda
food-fruit: Frutta
food-vegetable: Verdura
food-prepared: Cibo preparato
food-asian: Cibo asiatico
food-marine: Frutti di mare
food-sweet: Cibo dolce
drink: Bevanda
dishware: Stoviglie
travel-and-places: Viaggi e luoghi
place-map: Carta geografica
place-geographic: Luogo geografico
place-building: Edificio
place-religious: Luogo religioso
place-other: Altri posti
transport-ground: Trasporto via terra
transport-water: Trasporto per via d'acqua
transport-air: Trasporto aereo
hotel: Hotel
time: Tempo
sky-and-weather: Cielo e meteo
activities: Attività
event: Evento
award-medal: Medaglia e premio
sport: Sport
game: Gioco
arts-and-crafts: Artigianato
clothing: Capi di abbigliamento
sound: Suono
music: Musica
musical-instrument: Strumento musicale
phone: Telefono
computer: Computer
light-and-video: Luce e video
book-paper: Libro di carta
money: Soldi
mail: Posta
writing: Scrittura
office: Ufficio
lock: Serratura
tool: Attrezzo
science: Scienza
medical: Medicinale
household: Casa
other-object: Altri oggetti
transport-sign: Segno di trasporto
warning: Avvertimento
arrow: Freccia
religion: Religione
zodiac: Zodiaco
av-symbol: Simbolo AV
gender: Genere
math: Matematica
punctuation: Punteggiatura
other-symbol: Altri simboli
keycap: Keycap
alphanum: Caratteri alfanumerici
geometric: Forme geometriche
flag: Bandiera
country-flag: Bandiera del paese
subdivision-flag: Bandiera di suddivisione
smileys-and-emotion: Faccine ed emozione
people-and-body: Persone e corpo
component: Componente
animals-and-nature: Animali e natura
food-and-drink: Cibo bevanda
travel-and-places: Viaggi e luoghi
activities: Attività
objects: Oggetti
symbols: Simboli
flags: Bandiere