emotion: Emozione

joy: Faccia sorridente
love: Faccia amorosa
embarrassment: Viso timido
sympathy: Faccia preoccupata
discontent: Volto irritato
аnger: Faccia arrabbiata o scontenta
sadness: Faccia triste
pain: Faccia sofferente
fear: Viso spaventato
indifference: Volto scettico
confusion: Volto perplesso
doubt: Volto sospetto
surprise: Viso sorpreso
sleeping: Faccia assonnata
nosebleed: Faccia dolorosa


animals: Animali e insetti

cats: Faccia di gatto
dog: Muso del cane
bears: Orso la faccia
rabbits: Faccia coniglio
pig: Volto di maiale
bird: Uccellino
fish: Pesce
spider: Ragno


actions: Attività

greeting: Salutare
hug: Abbraccio
wink: Flirtare
apologizing: Scusarsi
hiding: Nascondere
writing: Scrivi
running: Correre
music: Cantare e ballare
games: Giocare a
food: Mangiare e bere
friends: Essere amici
enemies: Essere nemici
weapons: Sparare
magic: Fare magia