title: Цифры
list_title: Цифры
entity_fractions: Мнемоники и коды дробей в HTML
Arabic: Арабские
Roman: Римские
Actual: Актуальные
Archaic: Архаичные

Arab for Arabs = Indian Devanagari writing = understandable to us: Арабские для арабов = индийские в письменности деванагари = понятные нам
Circled: В круге
Negative circled: В чёрном круге
Double circled: В двойном круге 
Fractions: Дроби
Parenthesized: В скобках
Full stop: С точкой
Bold: Жирные
Double-struck: Двойные
Sans-Serif: Без засечек
Sans-Serif Bold: Жирные без засечек
Monospace: Моноширинные
Circled Sans-Serif: В круге без засечек
Negative Circled Sans-Serif: В чёрном круге без засечек
Fullwidth: Полноширинные

Devanagari: Деванагари
Bengali: Бенгальские
Gurmukhi: Гурмукхи
Gujarati: Гуджарати
Oriya: Ория
Tamil: Тамильские
Telugu: Телугу
Kannada: Каннада
Malayalam: Малаялам
Sinhala: Сингальские
Thai: Тайские
Lao: Лаосские
Tibetan: Тибетские
Myanmar: Бирманские
Khmer: Кхмерские
Limbu: Лимбу
New Tai Lue: Нового языка тай лы
Brahmi: Брахми

Indian: Индийские
Asian: Азиатские
Very old systems: Очень старые системы

Counting Rod Numerals: Счётные палочки
Cuneiform: Клинопись
Egyptian Hieroglyphs: Египетские иероглифические
Attic: Аттическая
Etruscan: Этрусская
Old Mongolian: Старые монгольские

African: Африканские
NKo: Нко
Ethiopic: Эфиопские
Sundanese: Суданские
Osmanya: Сомалийские (Османия)
Rumi Numeral Symbols: Числа системы руми
Adlam: Адламские
Coptic Epact Numbers: Старые коптские числа
Mende Kikakui: Кикакуи

Balinese: Балийские
Lepcha: Лепча
Vai: Ваи
Cham: Чамские
Chakma: Чакма
Khudawadi: Кхудабадийские
Newa: Неварские
Tirhuta: Тирхутские
Mro: Мро
Kayah Li: Кайях Ли
Pahawh Hmong: Пахау
Tai Tham Hora: Тай Тхам хора
Tai Tham Tham: Тай Тхам Тхам
Myanmar Tai Laing: Бирманская тай лаингские

Saurashtra: Саураштра
Javanese: Яванские
Kharoshthi: Кхароштхи
Sharada: Шарада
Modi: Моди
Takri: Такри
Ahom: Ахомские
Bhaiksuki: Байсаки
Bhaiksuki-n: Байсаки
Ol Chiki: Ол-чики
Meetei Mayek: Мейтей (Манипури)
Sora Sompeng: Сора Сомпенг
Warang Citi: Варанг-кшити
Masaram Gondi: Масарам

Non-positional number systems: Непозиционные системы счисления



















